"","word","net","up","down","Freq","ratio"
"1","abenzoyl",4,7,3,1,0.647475214374182
"2","able",39,57,18,36,0.878716362364961
"3","abouta",11,14,3,1,1.29495042874836
"4","aboutaud",9,12,3,1,1.10995751035574
"5","aboutmonth",4,7,3,1,0.647475214374182
"6","aboutmonths",40,61,21,49,0.80604057299643
"7","aboutweeks",35,50,15,25,0.924964591963116
"8","aboutyrs",4,7,3,1,0.647475214374182
"9","abp",8,14,6,4,0.647475214374182
"10","abrasive",18,24,6,4,1.10995751035574
"11","absolute",11,14,3,1,1.29495042874836
"12","absolutely",73,94,21,49,1.24209530920761
"13","absorb",27,36,9,9,1.10995751035574
"14","absorbed",9,12,3,1,1.10995751035574
"15","accelerate",9,12,3,1,1.10995751035574
"16","accepted",4,7,3,1,0.647475214374182
"17","accepting",9,12,3,1,1.10995751035574
"18","access",4,7,3,1,0.647475214374182
"19","according",23,29,6,4,1.34119865834652
"20","accumulated",17,20,3,1,1.84992918392623
"21","accurate",4,7,3,1,0.647475214374182
"22","accutane",562,784,222,5476,0.979962486620383
"23","accutanetimes",9,12,3,1,1.10995751035574
"24","accutaneyears",12,15,3,1,1.38744688794467
"25","acid",196,262,66,484,1.10154874133789
"26","acids",4,7,3,1,0.647475214374182
"27","acleanser",3,6,3,1,0.55497875517787
"29","acnefree",14,17,3,1,1.5724398063373
"30","acneketoconazole",11,14,3,1,1.29495042874836
"31","acneorg",16,28,12,16,0.647475214374182
"32","acnepimple",9,12,3,1,1.10995751035574
"33","acneprone",4,7,3,1,0.647475214374182
"34","across",9,12,3,1,1.10995751035574
"35","active",22,31,9,9,0.955796745028554
"36","acts",9,12,3,1,1.10995751035574
"37","actual",4,7,3,1,0.647475214374182
"38","actually",121,160,39,169,1.13841795933922
"39","acupuncture",17,20,3,1,1.84992918392623
"40","acutane",4,7,3,1,0.647475214374182
"41","aczone",8,14,6,4,0.647475214374182
"42","adapalene",17,26,9,9,0.801635979701368
"43","adapaleneand",4,7,3,1,0.647475214374182
"44","adapelene",4,7,3,1,0.647475214374182
"45","add",33,48,15,25,0.887966008284592
"46","added",13,19,6,4,0.878716362364961
"47","addgrams",15,18,3,1,1.66493626553361
"48","addictive",4,7,3,1,0.647475214374182
"49","adding",16,28,12,16,0.647475214374182
"50","addition",18,21,3,1,1.94242564312254
"51","addressed",9,12,3,1,1.10995751035574
"52","adequate",9,12,3,1,1.10995751035574
"53","adjusted",4,7,3,1,0.647475214374182
"54","adult",13,19,6,4,0.878716362364961
"55","adverse",4,7,3,1,0.647475214374182
"56","advice",92,128,36,144,0.986628898093991
"57","aesthetician",17,23,6,4,1.06370928075758
"58","aestheticians",4,7,3,1,0.647475214374182
"59","affect",8,14,6,4,0.647475214374182
"60","affecting",9,12,3,1,1.10995751035574
"61","affects",8,14,6,4,0.647475214374182
"62","afford",4,7,3,1,0.647475214374182
"63","affordable",4,7,3,1,0.647475214374182
"64","afraid",9,12,3,1,1.10995751035574
"65","african",12,15,3,1,1.38744688794467
"66","aftercycles",8,14,6,4,0.647475214374182
"67","afters",13,19,6,4,0.878716362364961
"68","afterward",22,28,6,4,1.29495042874836
"69","afterwards",13,16,3,1,1.47994334714099
"70","afterwords",4,7,3,1,0.647475214374182
"71","age",33,45,12,16,1.04058516595851
"72","aggravate",4,7,3,1,0.647475214374182
"73","aggravating",4,7,3,1,0.647475214374182
"74","aging",9,12,3,1,1.10995751035574
"75","ago",139,196,57,361,0.954174000130373
"76","agree",48,63,15,25,1.16545538587353
"77","aha",13,19,6,4,0.878716362364961
"78","ahaha",14,17,3,1,1.5724398063373
"79","ahahaalso",4,7,3,1,0.647475214374182
"80","ahas",12,21,9,9,0.647475214374182
"81","ai",4,7,3,1,0.647475214374182
"82","aid",11,14,3,1,1.29495042874836
"83","aimed",17,20,3,1,1.84992918392623
"84","aint",9,12,3,1,1.10995751035574
"85","aka",11,14,3,1,1.29495042874836
"86","alcohol",35,50,15,25,0.924964591963116
"87","alkaline",11,14,3,1,1.29495042874836
"88","allergens",4,7,3,1,0.647475214374182
"89","allergic",26,38,12,16,0.878716362364961
"90","allergies",4,7,3,1,0.647475214374182
"91","allergy",9,12,3,1,1.10995751035574
"92","allow",20,26,6,4,1.20245396955205
"93","allows",13,19,6,4,0.878716362364961
"94","almay",11,14,3,1,1.29495042874836
"95","almost",43,64,21,49,0.845681912651992
"96","alo",17,20,3,1,1.84992918392623
"97","aloe",33,51,18,36,0.786219903168649
"98","alone",53,80,27,81,0.822190748411659
"99","alonewere",4,7,3,1,0.647475214374182
"100","along",66,90,24,64,1.04058516595851
"101","alot",8,14,6,4,0.647475214374182
"102","alpha",18,24,6,4,1.10995751035574
"103","already",71,98,27,81,1.00718366680428
"104","alright",9,12,3,1,1.10995751035574
"106","alsomind",4,7,3,1,0.647475214374182
"107","alternative",11,14,3,1,1.29495042874836
"108","alternatively",9,12,3,1,1.10995751035574
"109","alternatives",18,24,6,4,1.10995751035574
"110","although",67,94,27,81,0.966074129383699
"111","always",140,200,60,400,0.924964591963116
"112","amand",26,35,9,9,1.0791253572903
"113","amazing",53,83,30,100,0.767720611329387
"114","amazon",32,47,15,25,0.869466716445329
"115","amazoncom",11,14,3,1,1.29495042874836
"116","amonths",4,7,3,1,0.647475214374182
"117","amount",55,76,21,49,1.00424727127424
"118","amounts",17,26,9,9,0.801635979701368
"119","amso",11,14,3,1,1.29495042874836
"120","analysisyou",11,14,3,1,1.29495042874836
"121","andbenzoil",4,7,3,1,0.647475214374182
"122","andbp",4,7,3,1,0.647475214374182
"123","androgen",15,21,6,4,0.971212821561272
"124","androgens",4,7,3,1,0.647475214374182
"125","andyet",4,7,3,1,0.647475214374182
"126","angle",12,15,3,1,1.38744688794467
"127","annoying",12,21,9,9,0.647475214374182
"128","another",48,69,21,49,0.911750812077929
"129","answer",17,26,9,9,0.801635979701368
"130","answered",13,19,6,4,0.878716362364961
"131","anti",25,31,6,4,1.43369511754283
"132","antiageing",4,7,3,1,0.647475214374182
"133","antibiotic",41,59,18,36,0.909548515430398
"134","antibiotics",114,162,48,256,0.936526649362655
"135","antidandruff",11,14,3,1,1.29495042874836
"136","antifungal",7,10,3,1,0.924964591963116
"137","antifungicals",11,14,3,1,1.29495042874836
"138","anxiety",18,24,6,4,1.10995751035574
"139","anymore",48,63,15,25,1.16545538587353
"140","anyone",16,22,6,4,1.01746105115943
"141","anything",133,190,57,361,0.924964591963116
"142","anytime",4,7,3,1,0.647475214374182
"143","anyway",40,52,12,16,1.20245396955205
"144","anyways",4,7,3,1,0.647475214374182
"145","anywhere",4,7,3,1,0.647475214374182
"146","aone",4,7,3,1,0.647475214374182
"147","apart",8,14,6,4,0.647475214374182
"148","aplly",18,24,6,4,1.10995751035574
"149","apologising",4,7,3,1,0.647475214374182
"150","app",4,7,3,1,0.647475214374182
"151","apparent",4,7,3,1,0.647475214374182
"152","appear",4,7,3,1,0.647475214374182
"153","appearance",18,24,6,4,1.10995751035574
"154","appearances",4,7,3,1,0.647475214374182
"155","appears",12,15,3,1,1.38744688794467
"156","apple",29,35,6,4,1.61868803593545
"157","applied",47,62,15,25,1.14695609403426
"158","applies",11,14,3,1,1.29495042874836
"159","apply",187,244,57,361,1.18784926546842
"160","applying",13,19,6,4,0.878716362364961
"161","applyingbenzol",15,18,3,1,1.66493626553361
"162","appointment",37,52,15,25,0.961963175641641
"163","appreciated",15,21,6,4,0.971212821561272
"164","apricot",14,17,3,1,1.5724398063373
"165","aquaphor",30,45,15,25,0.832468132766805
"166","aquation",4,7,3,1,0.647475214374182
"167","area",66,93,27,81,0.955796745028554
"168","arent",45,57,12,16,1.31807454354744
"169","argan",34,52,18,36,0.801635979701368
"170","armor",14,17,3,1,1.5724398063373
"171","around",101,137,36,144,1.05600124249122
"172","aroundmonths",9,12,3,1,1.10995751035574
"173","article",20,26,6,4,1.20245396955205
"174","articles",4,7,3,1,0.647475214374182
"175","asa",9,12,3,1,1.10995751035574
"176","asand",3,6,3,1,0.55497875517787
"177","asap",37,46,9,9,1.41827904101011
"178","asf",9,12,3,1,1.10995751035574
"179","ashamed",26,32,6,4,1.47994334714099
"180","asian",4,7,3,1,0.647475214374182
"181","aside",5,8,3,1,0.739971673570493
"182","ask",74,104,30,100,0.961963175641641
"183","asked",27,42,15,25,0.776970257249018
"184","asking",22,34,12,16,0.786219903168649
"185","asol",4,7,3,1,0.647475214374182
"186","assalso",4,7,3,1,0.647475214374182
"187","assume",11,14,3,1,1.29495042874836
"188","assuming",11,14,3,1,1.29495042874836
"189","astringent",4,7,3,1,0.647475214374182
"190","aswell",4,7,3,1,0.647475214374182
"191","ate",8,14,6,4,0.647475214374182
"192","athlete",9,12,3,1,1.10995751035574
"193","athletic",11,14,3,1,1.29495042874836
"194","athome",11,14,3,1,1.29495042874836
"195","ati",4,7,3,1,0.647475214374182
"196","atleast",4,7,3,1,0.647475214374182
"197","atmonths",4,7,3,1,0.647475214374182
"198","atso",11,14,3,1,1.29495042874836
"199","attempt",9,12,3,1,1.10995751035574
"200","attention",21,27,6,4,1.24870219915021
"201","attotally",4,7,3,1,0.647475214374182
"202","attractive",11,17,6,4,0.786219903168649
"203","august",15,21,6,4,0.971212821561272
"204","australia",9,12,3,1,1.10995751035574
"205","author",9,12,3,1,1.10995751035574
"206","aveeno",13,19,6,4,0.878716362364961
"207","avid",9,12,3,1,1.10995751035574
"208","avoid",131,170,39,169,1.20956908179792
"209","avoided",4,7,3,1,0.647475214374182
"210","avoiding",34,46,12,16,1.06370928075758
"211","aware",22,28,6,4,1.29495042874836
"212","away",189,264,75,625,0.976762609113051
"213","awesome",25,40,15,25,0.739971673570493
"214","awful",33,48,15,25,0.887966008284592
"215","azelaic",4,7,3,1,0.647475214374182
"216","b",58,82,24,64,0.948088706762194
"217","babies",27,33,6,4,1.52619157673914
"218","baby",15,18,3,1,1.66493626553361
"220","backing",4,7,3,1,0.647475214374182
"221","bacne",9,12,3,1,1.10995751035574
"222","bacteria",72,99,27,81,1.01746105115943
"223","bacterial",9,12,3,1,1.10995751035574
"224","bactrim",4,7,3,1,0.647475214374182
"225","bad",388,529,141,2209,1.04107716840104
"226","badly",13,19,6,4,0.878716362364961
"227","badyears",14,17,3,1,1.5724398063373
"228","bags",9,12,3,1,1.10995751035574
"229","baking",4,7,3,1,0.647475214374182
"230","balance",8,14,6,4,0.647475214374182
"231","balanced",34,40,6,4,1.84992918392623
"232","balm",57,75,18,36,1.1562057399539
"233","bandage",22,28,6,4,1.29495042874836
"234","bandages",34,43,9,9,1.3257825818138
"235","bandaid",22,28,6,4,1.29495042874836
"236","barbae",7,10,3,1,0.924964591963116
"237","bare",37,49,12,16,1.13308162515482
"238","barely",8,14,6,4,0.647475214374182
"239","bareminerals",22,28,6,4,1.29495042874836
"240","bares",11,14,3,1,1.29495042874836
"241","barrier",44,56,12,16,1.29495042874836
"242","base",11,14,3,1,1.29495042874836
"243","based",63,78,15,25,1.44294476346246
"244","basically",55,79,24,64,0.913402534563577
"245","bath",4,7,3,1,0.647475214374182
"246","bathroom",19,28,9,9,0.863300285832242
"247","battle",9,12,3,1,1.10995751035574
"248","battled",11,14,3,1,1.29495042874836
"249","battling",11,14,3,1,1.29495042874836
"250","bay",23,29,6,4,1.34119865834652
"251","bc",59,77,18,36,1.18703789301933
"252","bcp",12,21,9,9,0.647475214374182
"253","beard",7,10,3,1,0.924964591963116
"254","beat",4,7,3,1,0.647475214374182
"255","beating",9,12,3,1,1.10995751035574
"256","beautiful",21,27,6,4,1.24870219915021
"257","beauty",17,26,9,9,0.801635979701368
"258","beautyspf",11,14,3,1,1.29495042874836
"259","became",4,7,3,1,0.647475214374182
"260","become",22,31,9,9,0.955796745028554
"261","bed",38,50,12,16,1.1562057399539
"262","bedtime",9,12,3,1,1.10995751035574
"263","beef",4,7,3,1,0.647475214374182
"264","beenwithout",4,7,3,1,0.647475214374182
"265","bees",4,7,3,1,0.647475214374182
"266","began",8,14,6,4,0.647475214374182
"267","begin",26,35,9,9,1.0791253572903
"268","beginning",12,21,9,9,0.647475214374182
"269","behaviors",4,7,3,1,0.647475214374182
"270","behold",4,7,3,1,0.647475214374182
"271","believe",73,97,24,64,1.12151956775528
"272","believed",4,7,3,1,0.647475214374182
"273","believer",9,12,3,1,1.10995751035574
"274","bend",18,24,6,4,1.10995751035574
"275","benefit",22,28,6,4,1.29495042874836
"276","benefits",4,7,3,1,0.647475214374182
"277","benzol",18,24,6,4,1.10995751035574
"278","benzoyl",87,126,39,169,0.896504142979636
"279","benzyl",9,12,3,1,1.10995751035574
"280","besides",21,33,12,16,0.763095788369571
"281","best",247,334,87,841,1.06530404729545
"282","bestmonths",4,7,3,1,0.647475214374182
"283","better",282,402,120,1600,0.929589414922932
"284","beused",4,7,3,1,0.647475214374182
"285","beyond",11,14,3,1,1.29495042874836
"286","bha",27,36,9,9,1.10995751035574
"287","bhas",12,21,9,9,0.647475214374182
"288","big",110,140,30,100,1.29495042874836
"289","bigger",22,28,6,4,1.29495042874836
"290","biggest",10,16,6,4,0.739971673570493
"291","binge",4,7,3,1,0.647475214374182
"292","bio",9,12,3,1,1.10995751035574
"293","bioderma",8,14,6,4,0.647475214374182
"294","biotics",14,17,3,1,1.5724398063373
"295","biotin",27,36,9,9,1.10995751035574
"296","biotinjust",14,17,3,1,1.5724398063373
"297","birth",80,104,24,64,1.20245396955205
"298","birthmarks",4,7,3,1,0.647475214374182
"299","bismuth",33,42,9,9,1.29495042874836
"300","bit",83,113,30,100,1.04520998891832
"301","bitch",4,7,3,1,0.647475214374182
"302","bitchy",4,7,3,1,0.647475214374182
"303","bits",11,14,3,1,1.29495042874836
"304","black",58,73,15,25,1.35044830426615
"305","blackheads",13,19,6,4,0.878716362364961
"306","blade",4,7,3,1,0.647475214374182
"307","bland",4,7,3,1,0.647475214374182
"308","blemish",17,26,9,9,0.801635979701368
"309","blemishes",17,26,9,9,0.801635979701368
"310","blend",22,28,6,4,1.29495042874836
"311","blended",7,10,3,1,0.924964591963116
"312","bloatedpuffy",4,7,3,1,0.647475214374182
"313","blocker",11,14,3,1,1.29495042874836
"314","blood",46,67,21,49,0.885323252307554
"315","blotting",4,7,3,1,0.647475214374182
"316","blush",8,14,6,4,0.647475214374182
"317","body",300,414,114,1444,1.00772458177034
"318","bodytee",18,24,6,4,1.10995751035574
"319","bodythink",9,12,3,1,1.10995751035574
"320","boil",9,12,3,1,1.10995751035574
"321","book",9,12,3,1,1.10995751035574
"322","boost",18,24,6,4,1.10995751035574
"323","boosting",17,20,3,1,1.84992918392623
"324","boosts",4,7,3,1,0.647475214374182
"325","borage",4,7,3,1,0.647475214374182
"326","bothers",12,15,3,1,1.38744688794467
"327","bottle",31,40,9,9,1.23328612261749
"328","bottles",15,18,3,1,1.66493626553361
"329","bought",31,40,9,9,1.23328612261749
"330","bowel",9,12,3,1,1.10995751035574
"331","bowels",4,7,3,1,0.647475214374182
"332","bp",103,148,45,225,0.912631730736941
"333","bpbut",4,7,3,1,0.647475214374182
"334","bps",4,7,3,1,0.647475214374182
"335","braces",9,12,3,1,1.10995751035574
"336","brand",13,19,6,4,0.878716362364961
"337","brands",28,40,12,16,0.924964591963116
"338","braun",4,7,3,1,0.647475214374182
"339","bread",4,7,3,1,0.647475214374182
"340","break",152,218,66,484,0.91655582294527
"341","breakdown",4,7,3,1,0.647475214374182
"342","breaking",32,47,15,25,0.869466716445329
"343","breakout",86,119,33,121,1.00064351312374
"344","breakouts",100,133,33,121,1.11836627937359
"345","breastfeeding",15,18,3,1,1.66493626553361
"346","breastfeedingim",15,18,3,1,1.66493626553361
"347","breeding",4,7,3,1,0.647475214374182
"348","brewed",4,7,3,1,0.647475214374182
"349","brightening",4,7,3,1,0.647475214374182
"350","bring",9,12,3,1,1.10995751035574
"351","bringing",20,26,6,4,1.20245396955205
"352","bro",4,7,3,1,0.647475214374182
"353","broccoli",9,12,3,1,1.10995751035574
"354","broke",31,43,12,16,0.99433693636035
"355","broken",4,7,3,1,0.647475214374182
"356","bronners",4,7,3,1,0.647475214374182
"357","brought",36,45,9,9,1.38744688794467
"358","brown",15,21,6,4,0.971212821561272
"359","bruise",3,6,3,1,0.55497875517787
"360","brush",27,36,9,9,1.10995751035574
"361","btw",15,27,12,16,0.624351099575104
"362","bubble",4,7,3,1,0.647475214374182
"363","budget",4,7,3,1,0.647475214374182
"364","build",12,21,9,9,0.647475214374182
"365","buildable",11,14,3,1,1.29495042874836
"366","built",4,7,3,1,0.647475214374182
"367","bulk",4,7,3,1,0.647475214374182
"368","bulking",20,35,15,25,0.647475214374182
"369","bulkingmonths",4,7,3,1,0.647475214374182
"370","bummed",4,7,3,1,0.647475214374182
"371","bump",4,7,3,1,0.647475214374182
"372","bumps",24,42,18,36,0.647475214374182
"373","bunch",35,47,12,16,1.08683339555666
"374","burger",4,7,3,1,0.647475214374182
"375","burned",11,14,3,1,1.29495042874836
"376","burning",16,25,9,9,0.77080382663593
"377","burns",9,12,3,1,1.10995751035574
"378","burnsdrys",4,7,3,1,0.647475214374182
"379","burts",4,7,3,1,0.647475214374182
"380","business",21,27,6,4,1.24870219915021
"381","butter",4,7,3,1,0.647475214374182
"382","buy",81,108,27,81,1.10995751035574
"383","c",93,120,27,81,1.23328612261749
"384","caffeine",13,19,6,4,0.878716362364961
"385","cakey",11,14,3,1,1.29495042874836
"386","calcium",4,7,3,1,0.647475214374182
"387","call",9,12,3,1,1.10995751035574
"388","called",86,119,33,121,1.00064351312374
"389","callousing",9,12,3,1,1.10995751035574
"390","calorie",4,7,3,1,0.647475214374182
"391","came",68,92,24,64,1.06370928075758
"393","canadian",4,7,3,1,0.647475214374182
"394","cancer",14,17,3,1,1.5724398063373
"395","candida",4,7,3,1,0.647475214374182
"396","candy",9,12,3,1,1.10995751035574
"397","cane",8,14,6,4,0.647475214374182
"398","cant",161,218,57,361,1.06127516341031
"399","capric",4,7,3,1,0.647475214374182
"400","capryliccapric",4,7,3,1,0.647475214374182
"401","capsule",9,12,3,1,1.10995751035574
"402","capsules",9,12,3,1,1.10995751035574
"403","carb",4,7,3,1,0.647475214374182
"404","carbohydrates",9,12,3,1,1.10995751035574
"405","carbs",21,33,12,16,0.763095788369571
"406","carcinogen",11,14,3,1,1.29495042874836
"407","care",112,151,39,169,1.07438194912639
"408","careful",22,31,9,9,0.955796745028554
"409","carefully",4,7,3,1,0.647475214374182
"410","caroline",14,17,3,1,1.5724398063373
"411","carrots",52,64,12,16,1.47994334714099
"412","carry",13,19,6,4,0.878716362364961
"413","case",34,52,18,36,0.801635979701368
"414","cases",14,17,3,1,1.5724398063373
"415","cause",178,238,60,400,1.10070786443611
"416","caused",29,44,15,25,0.813968840927542
"417","causes",65,92,27,81,0.945519360673408
"418","causing",64,88,24,64,1.01746105115943
"419","caved",9,12,3,1,1.10995751035574
"420","caveman",37,49,12,16,1.13308162515482
"421","cbd",18,24,6,4,1.10995751035574
"422","ccastor",11,14,3,1,1.29495042874836
"423","cell",22,31,9,9,0.955796745028554
"424","cells",4,7,3,1,0.647475214374182
"425","centrum",4,7,3,1,0.647475214374182
"426","ceramides",11,14,3,1,1.29495042874836
"427","cerave",125,170,45,225,1.04829320422487
"428","cereve",4,7,3,1,0.647475214374182
"429","certainly",9,12,3,1,1.10995751035574
"430","certified",4,7,3,1,0.647475214374182
"431","cetaphil",40,61,21,49,0.80604057299643
"432","ceva",11,14,3,1,1.29495042874836
"433","challenge",9,12,3,1,1.10995751035574
"434","chance",23,29,6,4,1.34119865834652
"435","change",163,217,54,324,1.11509620253331
"436","changed",50,71,21,49,0.938178371848304
"437","changegood",9,12,3,1,1.10995751035574
"438","changes",70,100,30,100,0.924964591963116
"439","changesregular",4,7,3,1,0.647475214374182
"440","changing",76,94,18,36,1.44911119407555
"441","chaning",4,7,3,1,0.647475214374182
"442","chapped",9,12,3,1,1.10995751035574
"443","chapstick",25,34,9,9,1.04829320422487
"444","charcoal",46,61,15,25,1.128456802195
"445","cheap",52,73,21,49,0.964605931618679
"446","cheaper",4,7,3,1,0.647475214374182
"447","cheat",4,7,3,1,0.647475214374182
"448","check",41,53,12,16,1.22557808435113
"449","checkeddoxy",11,14,3,1,1.29495042874836
"450","checkwould",11,14,3,1,1.29495042874836
"451","cheekbones",4,7,3,1,0.647475214374182
"452","cheeks",72,102,30,100,0.943463883802379
"453","cheese",13,19,6,4,0.878716362364961
"454","cheesesoy",4,7,3,1,0.647475214374182
"455","chemical",27,39,12,16,0.901840477164038
"456","chemicals",13,16,3,1,1.47994334714099
"457","chest",43,58,15,25,1.07295892667722
"458","chestback",36,48,12,16,1.10995751035574
"459","chicken",21,33,12,16,0.763095788369571
"460","child",4,7,3,1,0.647475214374182
"461","chin",68,98,30,100,0.906465300123854
"462","chocolate",9,12,3,1,1.10995751035574
"463","choice",52,67,15,25,1.23945255323058
"464","choose",11,14,3,1,1.29495042874836
"465","cidear",4,7,3,1,0.647475214374182
"466","circular",9,12,3,1,1.10995751035574
"467","classes",9,12,3,1,1.10995751035574
"468","classic",16,22,6,4,1.01746105115943
"469","classicly",9,12,3,1,1.10995751035574
"470","classmates",11,14,3,1,1.29495042874836
"471","clay",36,48,12,16,1.10995751035574
"472","clean",66,93,27,81,0.955796745028554
"473","cleaning",18,24,6,4,1.10995751035574
"474","cleans",4,7,3,1,0.647475214374182
"475","cleanse",41,56,15,25,1.03596034299869
"476","cleansedtimes",4,7,3,1,0.647475214374182
"477","cleanser",153,204,51,289,1.10995751035574
"478","cleansernon",11,14,3,1,1.29495042874836
"479","cleansers",20,29,9,9,0.894132438897679
"480","cleansing",64,91,27,81,0.935241976318262
"481","cleansingmoisturising",9,12,3,1,1.10995751035574
"482","clear",199,277,78,676,0.985443046053012
"483","cleared",143,200,57,361,0.973646938908543
"484","clearer",23,29,6,4,1.34119865834652
"485","clearest",4,7,3,1,0.647475214374182
"486","clearing",57,78,21,49,1.03067483104462
"487","clears",35,47,12,16,1.08683339555666
"488","clearskin",4,7,3,1,0.647475214374182
"489","clients",4,7,3,1,0.647475214374182
"490","clindamycin",29,41,12,16,0.948088706762194
"491","clindamycine",4,7,3,1,0.647475214374182
"492","clinical",4,7,3,1,0.647475214374182
"493","clinique",40,52,12,16,1.20245396955205
"494","cliniques",11,14,3,1,1.29495042874836
"495","clog",8,14,6,4,0.647475214374182
"496","clogged",39,54,15,25,0.998961759320166
"497","cloggedi",4,7,3,1,0.647475214374182
"498","clogs",11,14,3,1,1.29495042874836
"499","close",13,19,6,4,0.878716362364961
"500","closed",30,39,9,9,1.20245396955205
"501","closer",17,20,3,1,1.84992918392623
"502","cloth",18,24,6,4,1.10995751035574
"503","clothessizes",18,21,3,1,1.94242564312254
"504","clundamycin",4,7,3,1,0.647475214374182
"505","coconut",82,118,36,144,0.909548515430398
"506","code",4,7,3,1,0.647475214374182
"507","coffee",26,38,12,16,0.878716362364961
"508","coincide",4,7,3,1,0.647475214374182
"509","cold",7,13,6,4,0.601226984776026
"510","color",15,21,6,4,0.971212821561272
"511","coloration",4,7,3,1,0.647475214374182
"512","colors",22,28,6,4,1.29495042874836
"513","combat",9,12,3,1,1.10995751035574
"514","combination",26,38,12,16,0.878716362364961
"515","combined",12,21,9,9,0.647475214374182
"516","come",110,152,42,196,1.00424727127424
"517","comedogenic",62,80,18,36,1.23328612261749
"518","comedogenicirritating",11,14,3,1,1.29495042874836
"519","comedones",35,44,9,9,1.35661473487924
"520","comedonesacne",4,7,3,1,0.647475214374182
"521","comes",66,96,30,100,0.887966008284592
"522","comfortable",4,7,3,1,0.647475214374182
"523","coming",44,62,18,36,0.955796745028554
"524","comment",13,19,6,4,0.878716362364961
"525","committing",18,21,3,1,1.94242564312254
"526","common",12,21,9,9,0.647475214374182
"527","community",4,7,3,1,0.647475214374182
"528","companies",4,7,3,1,0.647475214374182
"529","compared",10,16,6,4,0.739971673570493
"530","comparing",11,14,3,1,1.29495042874836
"531","complain",4,7,3,1,0.647475214374182
"532","completely",96,135,39,169,0.960540153192467
"533","completion",3,6,3,1,0.55497875517787
"534","complex",15,21,6,4,0.971212821561272
"535","complexion",15,21,6,4,0.971212821561272
"536","compress",9,12,3,1,1.10995751035574
"537","compromised",9,12,3,1,1.10995751035574
"538","concentration",12,18,6,4,0.832468132766805
"539","concerned",4,7,3,1,0.647475214374182
"540","condition",19,25,6,4,1.1562057399539
"541","conditions",30,36,6,4,1.66493626553361
"542","confidence",15,21,6,4,0.971212821561272
"543","confident",13,19,6,4,0.878716362364961
"544","congratulations",22,31,9,9,0.955796745028554
"545","connect",4,7,3,1,0.647475214374182
"546","cons",25,31,6,4,1.43369511754283
"547","consciousness",11,14,3,1,1.29495042874836
"548","consented",14,17,3,1,1.5724398063373
"549","consider",74,98,24,64,1.13308162515482
"550","considered",13,19,6,4,0.878716362364961
"551","considering",18,24,6,4,1.10995751035574
"552","consistent",59,77,18,36,1.18703789301933
"553","consistently",13,19,6,4,0.878716362364961
"554","constantly",9,12,3,1,1.10995751035574
"555","consult",11,14,3,1,1.29495042874836
"556","consume",22,31,9,9,0.955796745028554
"557","consumed",9,12,3,1,1.10995751035574
"558","consuming",15,18,3,1,1.66493626553361
"559","contacts",8,14,6,4,0.647475214374182
"560","containing",4,7,3,1,0.647475214374182
"561","contains",18,24,6,4,1.10995751035574
"562","containsbenzoyl",9,12,3,1,1.10995751035574
"563","contemplating",11,14,3,1,1.29495042874836
"564","continue",46,64,18,36,0.986628898093991
"565","continues",12,15,3,1,1.38744688794467
"566","contribute",22,31,9,9,0.955796745028554
"567","contributed",14,17,3,1,1.5724398063373
"568","control",100,130,30,100,1.20245396955205
"569","controlling",9,12,3,1,1.10995751035574
"570","controls",4,7,3,1,0.647475214374182
"571","controlthat",4,7,3,1,0.647475214374182
"572","controversial",9,12,3,1,1.10995751035574
"573","convenance",9,12,3,1,1.10995751035574
"574","cool",27,39,12,16,0.901840477164038
"575","cooling",18,24,6,4,1.10995751035574
"576","cools",9,12,3,1,1.10995751035574
"577","cope",4,7,3,1,0.647475214374182
"578","corn",17,20,3,1,1.84992918392623
"579","corrector",9,12,3,1,1.10995751035574
"580","correlated",9,12,3,1,1.10995751035574
"581","correlation",19,25,6,4,1.1562057399539
"582","cosrx",4,7,3,1,0.647475214374182
"583","cosrxits",4,7,3,1,0.647475214374182
"584","cost",51,69,18,36,1.06370928075758
"585","cotton",9,12,3,1,1.10995751035574
"586","couldnt",28,40,12,16,0.924964591963116
"587","count",4,7,3,1,0.647475214374182
"588","counter",14,17,3,1,1.5724398063373
"589","countless",20,26,6,4,1.20245396955205
"590","country",4,7,3,1,0.647475214374182
"591","couple",87,120,33,121,1.00905228214158
"592","course",70,97,27,81,0.996906282449137
"593","cover",62,83,21,49,1.09674373047055
"594","coverage",33,45,12,16,1.04058516595851
"595","covering",9,12,3,1,1.10995751035574
"596","covers",4,7,3,1,0.647475214374182
"597","cows",4,7,3,1,0.647475214374182
"598","crack",9,12,3,1,1.10995751035574
"599","crap",8,14,6,4,0.647475214374182
"600","craters",4,7,3,1,0.647475214374182
"601","cratersit",11,14,3,1,1.29495042874836
"602","crazily",4,7,3,1,0.647475214374182
"603","crazy",48,63,15,25,1.16545538587353
"604","cream",81,111,30,100,1.02671069707906
"605","creamfor",14,17,3,1,1.5724398063373
"606","creams",21,33,12,16,0.763095788369571
"607","create",11,14,3,1,1.29495042874836
"608","created",9,12,3,1,1.10995751035574
"609","creatine",18,24,6,4,1.10995751035574
"610","credit",4,7,3,1,0.647475214374182
"611","creme",9,12,3,1,1.10995751035574
"612","cremes",9,12,3,1,1.10995751035574
"613","cried",5,8,3,1,0.739971673570493
"614","cry",9,12,3,1,1.10995751035574
"615","cucumbers",15,18,3,1,1.66493626553361
"616","culprit",4,7,3,1,0.647475214374182
"617","culture",9,12,3,1,1.10995751035574
"618","cup",8,14,6,4,0.647475214374182
"619","cups",4,7,3,1,0.647475214374182
"620","cure",46,64,18,36,0.986628898093991
"621","cured",27,36,9,9,1.10995751035574
"622","curology",8,14,6,4,0.647475214374182
"623","current",45,63,18,36,0.971212821561272
"624","currently",74,101,27,81,1.03801581986972
"625","cus",4,7,3,1,0.647475214374182
"626","cut",84,123,39,169,0.875158806242025
"627","cuts",15,18,3,1,1.66493626553361
"628","cutting",58,79,21,49,1.0438886109298
"629","cuz",36,51,15,25,0.943463883802379
"630","cycle",8,14,6,4,0.647475214374182
"631","cycleended",4,7,3,1,0.647475214374182
"632","cyclen",4,7,3,1,0.647475214374182
"633","cycles",13,19,6,4,0.878716362364961
"634","cyst",47,68,21,49,0.898537032192742
"635","cystic",158,233,75,625,0.862066999709624
"636","cystics",8,14,6,4,0.647475214374182
"637","cysts",57,78,21,49,1.03067483104462
"638","d",42,60,18,36,0.924964591963116
"639","dab",3,6,3,1,0.55497875517787
"640","dad",7,10,3,1,0.924964591963116
"641","daily",83,119,36,144,0.917256553696757
"642","dair",9,12,3,1,1.10995751035574
"643","dairy",279,384,105,1225,1.01481829518239
"644","dairye",9,12,3,1,1.10995751035574
"645","damage",45,57,12,16,1.31807454354744
"646","damn",33,42,9,9,1.29495042874836
"647","damp",9,12,3,1,1.10995751035574
"648","dance",11,14,3,1,1.29495042874836
"649","dandruff",33,42,9,9,1.29495042874836
"650","dangerous",9,12,3,1,1.10995751035574
"651","dark",23,35,12,16,0.809344017967727
"652","darker",15,21,6,4,0.971212821561272
"653","database",14,20,6,4,0.924964591963116
"654","date",6,9,3,1,0.832468132766805
"655","day",397,559,162,2916,0.957509642421078
"656","daycucumberssticks",15,18,3,1,1.66493626553361
"657","days",97,130,33,121,1.09313997232005
"658","daytime",15,21,6,4,0.971212821561272
"659","deal",24,33,9,9,1.01746105115943
"660","dealing",30,42,12,16,0.971212821561272
"661","dealt",9,12,3,1,1.10995751035574
"662","decent",25,31,6,4,1.43369511754283
"663","decided",35,50,15,25,0.924964591963116
"664","decision",58,76,18,36,1.17162181648661
"665","decrease",11,14,3,1,1.29495042874836
"666","decreased",9,12,3,1,1.10995751035574
"667","decreasing",9,12,3,1,1.10995751035574
"668","deep",45,66,21,49,0.872109472422367
"669","deeper",4,7,3,1,0.647475214374182
"670","def",33,42,9,9,1.29495042874836
"671","defenitley",12,15,3,1,1.38744688794467
"672","deficiencies",12,15,3,1,1.38744688794467
"673","deficiency",4,7,3,1,0.647475214374182
"674","definately",4,7,3,1,0.647475214374182
"675","define",22,31,9,9,0.955796745028554
"676","defined",4,7,3,1,0.647475214374182
"677","definitely",187,253,66,484,1.06370928075758
"678","degrade",12,15,3,1,1.38744688794467
"679","degree",9,12,3,1,1.10995751035574
"680","dehydrated",9,12,3,1,1.10995751035574
"681","dehydration",4,7,3,1,0.647475214374182
"682","deleted",29,41,12,16,0.948088706762194
"683","deletthis",4,7,3,1,0.647475214374182
"684","delicate",14,17,3,1,1.5724398063373
"685","delt",4,7,3,1,0.647475214374182
"686","depends",4,7,3,1,0.647475214374182
"687","depressed",26,38,12,16,0.878716362364961
"688","depression",13,19,6,4,0.878716362364961
"689","depressioned",4,7,3,1,0.647475214374182
"690","depressive",9,12,3,1,1.10995751035574
"691","derived",4,7,3,1,0.647475214374182
"692","derm",166,232,66,484,0.975417206070195
"693","derma",51,66,15,25,1.22095326139131
"694","dermablend",7,10,3,1,0.924964591963116
"695","dermatologist",356,482,126,1764,1.06150698411005
"696","dermatologistits",4,7,3,1,0.647475214374182
"697","dermatologists",4,7,3,1,0.647475214374182
"698","dermotologist",14,17,3,1,1.5724398063373
"699","derms",9,12,3,1,1.10995751035574
"700","described",13,19,6,4,0.878716362364961
"701","describing",4,7,3,1,0.647475214374182
"702","desogyn",4,7,3,1,0.647475214374182
"703","desperate",19,28,9,9,0.863300285832242
"704","destroyed",4,7,3,1,0.647475214374182
"705","determine",18,24,6,4,1.10995751035574
"706","devastated",4,7,3,1,0.647475214374182
"707","develop",12,21,9,9,0.647475214374182
"708","developed",13,19,6,4,0.878716362364961
"709","dht",8,14,6,4,0.647475214374182
"710","diagnosis",9,12,3,1,1.10995751035574
"711","dianewas",4,7,3,1,0.647475214374182
"712","diarrhea",4,7,3,1,0.647475214374182
"713","diary",4,7,3,1,0.647475214374182
"715","die",4,7,3,1,0.647475214374182
"716","diet",335,446,111,1369,1.11495731896095
"717","dietall",9,12,3,1,1.10995751035574
"718","dietary",18,24,6,4,1.10995751035574
"719","dietician",11,14,3,1,1.29495042874836
"720","diets",9,12,3,1,1.10995751035574
"721","differ",9,12,3,1,1.10995751035574
"722","differece",9,12,3,1,1.10995751035574
"723","difference",86,128,42,196,0.845681912651992
"724","differences",22,28,6,4,1.29495042874836
"725","different",206,278,72,576,1.07141731902394
"726","differently",18,24,6,4,1.10995751035574
"727","differin",126,162,36,144,1.24870219915021
"728","differinbenzoyl",11,14,3,1,1.29495042874836
"729","differinprescribed",4,7,3,1,0.647475214374182
"730","differintret",9,12,3,1,1.10995751035574
"731","differinyes",4,7,3,1,0.647475214374182
"732","differns",4,7,3,1,0.647475214374182
"733","difficult",4,7,3,1,0.647475214374182
"734","diffrenadapalene",4,7,3,1,0.647475214374182
"735","diffrens",4,7,3,1,0.647475214374182
"736","diffuse",4,7,3,1,0.647475214374182
"737","digestionirregular",4,7,3,1,0.647475214374182
"738","diluted",4,7,3,1,0.647475214374182
"739","dim",4,7,3,1,0.647475214374182
"740","dimmer",11,14,3,1,1.29495042874836
"741","dinner",11,14,3,1,1.29495042874836
"742","dioxide",36,45,9,9,1.38744688794467
"743","dip",9,12,3,1,1.10995751035574
"744","directed",4,7,3,1,0.647475214374182
"745","direction",9,12,3,1,1.10995751035574
"746","directions",9,12,3,1,1.10995751035574
"747","dirt",30,39,9,9,1.20245396955205
"748","disappear",13,19,6,4,0.878716362364961
"749","disappears",9,12,3,1,1.10995751035574
"750","disclaimer",4,7,3,1,0.647475214374182
"751","discoloration",18,24,6,4,1.10995751035574
"752","discontinue",17,20,3,1,1.84992918392623
"753","discourage",4,7,3,1,0.647475214374182
"754","discouraged",4,7,3,1,0.647475214374182
"755","discovering",9,12,3,1,1.10995751035574
"756","discuss",11,14,3,1,1.29495042874836
"757","disgust",17,20,3,1,1.84992918392623
"758","disgusted",12,15,3,1,1.38744688794467
"759","disheartened",4,7,3,1,0.647475214374182
"760","dismissive",4,7,3,1,0.647475214374182
"761","dispersed",4,7,3,1,0.647475214374182
"762","dissipate",9,12,3,1,1.10995751035574
"763","distress",4,7,3,1,0.647475214374182
"764","divided",9,12,3,1,1.10995751035574
"765","dm",4,7,3,1,0.647475214374182
"766","doc",20,26,6,4,1.20245396955205
"767","doctor",156,213,57,361,1.0369339899376
"768","doctors",4,7,3,1,0.647475214374182
"769","doenst",18,24,6,4,1.10995751035574
"770","doesnt",249,339,90,900,1.04520998891832
"771","dollars",9,12,3,1,1.10995751035574
"772","done",89,122,33,121,1.02586982017727
"774","dosage",3,6,3,1,0.55497875517787
"775","dosages",4,7,3,1,0.647475214374182
"776","dose",26,32,6,4,1.47994334714099
"777","dots",4,7,3,1,0.647475214374182
"778","double",9,12,3,1,1.10995751035574
"779","downside",11,14,3,1,1.29495042874836
"780","doxy",56,83,27,81,0.853022901477096
"781","doxybactrim",9,12,3,1,1.10995751035574
"782","doxycline",4,7,3,1,0.647475214374182
"783","doxycycline",39,57,18,36,0.878716362364961
"784","dr",34,52,18,36,0.801635979701368
"785","drained",9,12,3,1,1.10995751035574
"786","dramatically",11,14,3,1,1.29495042874836
"787","drank",11,14,3,1,1.29495042874836
"788","drastic",22,31,9,9,0.955796745028554
"789","drawn",4,7,3,1,0.647475214374182
"790","drier",4,7,3,1,0.647475214374182
"791","dries",20,32,12,16,0.739971673570493
"792","drink",124,169,45,225,1.04212677361178
"793","drinking",31,52,21,49,0.687116554029744
"794","drinks",13,19,6,4,0.878716362364961
"795","drops",49,70,21,49,0.924964591963116
"796","drug",115,154,39,169,1.095727285864
"797","dry",187,253,66,484,1.06370928075758
"798","drycrucial",14,17,3,1,1.5724398063373
"799","dryer",4,7,3,1,0.647475214374182
"800","dryi",9,12,3,1,1.10995751035574
"801","drying",54,75,21,49,0.991033491389053
"802","dryness",61,85,24,64,0.982774878960811
"803","dscar",14,17,3,1,1.5724398063373
"804","duac",13,19,6,4,0.878716362364961
"805","dude",11,14,3,1,1.29495042874836
"806","dudu",14,17,3,1,1.5724398063373
"807","due",54,75,21,49,0.991033491389053
"808","dull",4,7,3,1,0.647475214374182
"809","duration",17,20,3,1,1.84992918392623
"810","dusting",11,14,3,1,1.29495042874836
"811","dysmorphia",4,7,3,1,0.647475214374182
"812","e",16,22,6,4,1.01746105115943
"813","ear",11,14,3,1,1.29495042874836
"814","earlier",14,17,3,1,1.5724398063373
"815","early",4,7,3,1,0.647475214374182
"816","earth",9,12,3,1,1.10995751035574
"817","ease",4,7,3,1,0.647475214374182
"818","easier",14,17,3,1,1.5724398063373
"819","easiest",9,12,3,1,1.10995751035574
"820","easily",13,19,6,4,0.878716362364961
"821","easy",46,61,15,25,1.128456802195
"822","eat",147,198,51,289,1.07731170122763
"823","eatdrink",4,7,3,1,0.647475214374182
"824","eating",140,197,57,361,0.959042234824915
"825","eatingcalories",4,7,3,1,0.647475214374182
"826","eczema",12,15,3,1,1.38744688794467
"827","edge",9,12,3,1,1.10995751035574
"828","edit",51,69,18,36,1.06370928075758
"829","edited",4,7,3,1,0.647475214374182
"830","edithydrogen",3,6,3,1,0.55497875517787
"831","editi",9,12,3,1,1.10995751035574
"832","edm",22,28,6,4,1.29495042874836
"833","edms",11,14,3,1,1.29495042874836
"834","educated",4,7,3,1,0.647475214374182
"835","effaclar",9,12,3,1,1.10995751035574
"836","effect",57,75,18,36,1.1562057399539
"837","effective",102,138,36,144,1.06370928075758
"838","effectiveness",13,19,6,4,0.878716362364961
"839","effects",132,192,60,400,0.887966008284592
"840","effort",20,26,6,4,1.20245396955205
"841","eggs",30,45,15,25,0.832468132766805
"842","either",76,118,42,196,0.779613013226055
"843","electric",8,14,6,4,0.647475214374182
"844","electrolosys",7,10,3,1,0.924964591963116
"845","elf",11,14,3,1,1.29495042874836
"846","eliminate",9,12,3,1,1.10995751035574
"847","eliminating",9,12,3,1,1.10995751035574
"848","elimination",9,12,3,1,1.10995751035574
"849","else",95,131,36,144,1.00975301289307
"850","embarrassed",20,29,9,9,0.894132438897679
"851","emergency",3,6,3,1,0.55497875517787
"852","emmolient",24,30,6,4,1.38744688794467
"853","emotional",18,24,6,4,1.10995751035574
"854","encorporating",4,7,3,1,0.647475214374182
"855","end",79,109,30,100,1.0082114052398
"856","ended",8,14,6,4,0.647475214374182
"857","enjoy",9,12,3,1,1.10995751035574
"858","enough",39,57,18,36,0.878716362364961
"859","ensuring",4,7,3,1,0.647475214374182
"860","entire",4,7,3,1,0.647475214374182
"861","environmental",11,14,3,1,1.29495042874836
"862","enzymes",11,14,3,1,1.29495042874836
"863","enzymesgood",11,14,3,1,1.29495042874836
"864","epaderm",12,15,3,1,1.38744688794467
"865","epiduo",89,125,36,144,0.963504783294913
"866","equivalent",4,7,3,1,0.647475214374182
"867","eradicated",4,7,3,1,0.647475214374182
"868","error",4,7,3,1,0.647475214374182
"869","erupts",15,18,3,1,1.66493626553361
"870","escapes",9,12,3,1,1.10995751035574
"871","eskinol",9,12,3,1,1.10995751035574
"872","esp",4,7,3,1,0.647475214374182
"873","especially",85,109,24,64,1.26026425654975
"874","essentialy",4,7,3,1,0.647475214374182
"875","esteem",9,12,3,1,1.10995751035574
"876","esthetician",14,17,3,1,1.5724398063373
"877","estheticians",14,17,3,1,1.5724398063373
"878","estrogen",4,7,3,1,0.647475214374182
"879","estrogens",4,7,3,1,0.647475214374182
"880","europe",9,12,3,1,1.10995751035574
"881","eurosmonth",4,7,3,1,0.647475214374182
"882","evaluate",11,14,3,1,1.29495042874836
"883","evaporate",9,12,3,1,1.10995751035574
"884","even",218,305,87,841,0.97280758809914
"885","evening",13,19,6,4,0.878716362364961
"886","evenly",9,12,3,1,1.10995751035574
"887","eventually",38,50,12,16,1.1562057399539
"888","ever",177,240,63,441,1.05710239081499
"889","every",261,354,93,961,1.05624988888691
"890","everybody",4,7,3,1,0.647475214374182
"891","everyday",82,112,30,100,1.03596034299869
"892","everydaycucumberssticks",14,17,3,1,1.5724398063373
"893","everydayi",18,24,6,4,1.10995751035574
"894","everydays",12,15,3,1,1.38744688794467
"895","everymonths",4,7,3,1,0.647475214374182
"896","everyone",68,92,24,64,1.06370928075758
"897","everyones",17,26,9,9,0.801635979701368
"898","everything",153,207,54,324,1.06370928075758
"899","ex",9,12,3,1,1.10995751035574
"900","exacerbated",4,7,3,1,0.647475214374182
"901","exact",12,21,9,9,0.647475214374182
"902","exactly",43,55,12,16,1.27182631394928
"903","exactlygood",15,18,3,1,1.66493626553361
"904","example",8,14,6,4,0.647475214374182
"905","except",19,25,6,4,1.1562057399539
"906","excercise",9,12,3,1,1.10995751035574
"907","excess",24,33,9,9,1.01746105115943
"908","excessive",8,14,6,4,0.647475214374182
"909","excruciatingly",4,7,3,1,0.647475214374182
"910","execessive",4,7,3,1,0.647475214374182
"911","exercise",22,31,9,9,0.955796745028554
"912","exfoliant",14,17,3,1,1.5724398063373
"913","exfoliate",18,24,6,4,1.10995751035574
"914","exfoliates",9,12,3,1,1.10995751035574
"915","exfoliating",4,7,3,1,0.647475214374182
"916","exfoliatingtimes",9,12,3,1,1.10995751035574
"917","exfoliation",4,7,3,1,0.647475214374182
"918","exfoliator",18,24,6,4,1.10995751035574
"919","existed",4,7,3,1,0.647475214374182
"920","exotic",4,7,3,1,0.647475214374182
"921","expanding",4,7,3,1,0.647475214374182
"922","expectations",4,7,3,1,0.647475214374182
"923","expensive",69,87,18,36,1.34119865834652
"924","experiement",9,12,3,1,1.10995751035574
"925","experience",92,128,36,144,0.986628898093991
"926","experienced",27,36,9,9,1.10995751035574
"927","experiences",18,24,6,4,1.10995751035574
"928","experiencing",15,21,6,4,0.971212821561272
"929","experiment",18,24,6,4,1.10995751035574
"930","experimenting",13,16,3,1,1.47994334714099
"931","experts",9,12,3,1,1.10995751035574
"932","expimple",9,12,3,1,1.10995751035574
"933","explore",9,12,3,1,1.10995751035574
"934","exposure",4,7,3,1,0.647475214374182
"935","extra",17,26,9,9,0.801635979701368
"936","extracts",4,7,3,1,0.647475214374182
"937","extras",4,7,3,1,0.647475214374182
"938","extreme",4,7,3,1,0.647475214374182
"939","extremely",66,84,18,36,1.29495042874836
"940","exzema",4,7,3,1,0.647475214374182
"941","eyes",24,33,9,9,1.01746105115943
"942","f",14,17,3,1,1.5724398063373
"943","fabulous",16,22,6,4,1.01746105115943
"945","facemorning",9,12,3,1,1.10995751035574
"946","faces",17,20,3,1,1.84992918392623
"947","facetimes",8,14,6,4,0.647475214374182
"948","facewash",4,7,3,1,0.647475214374182
"949","facial",22,31,9,9,0.955796745028554
"950","fact",8,14,6,4,0.647475214374182
"951","factor",4,7,3,1,0.647475214374182
"952","factors",15,21,6,4,0.971212821561272
"953","fade",34,46,12,16,1.06370928075758
"954","fadingcould",4,7,3,1,0.647475214374182
"955","fail",4,7,3,1,0.647475214374182
"956","failed",9,12,3,1,1.10995751035574
"957","failsaccutane",15,18,3,1,1.66493626553361
"958","fair",11,14,3,1,1.29495042874836
"959","fairly",12,21,9,9,0.647475214374182
"960","faking",4,7,3,1,0.647475214374182
"961","fall",9,12,3,1,1.10995751035574
"962","familiar",9,12,3,1,1.10995751035574
"963","family",4,7,3,1,0.647475214374182
"964","far",18,24,6,4,1.10995751035574
"965","fast",52,73,21,49,0.964605931618679
"966","faster",40,58,18,36,0.894132438897679
"967","fats",27,36,9,9,1.10995751035574
"968","fatty",13,19,6,4,0.878716362364961
"969","fault",4,7,3,1,0.647475214374182
"970","favorite",20,26,6,4,1.20245396955205
"971","favourite",12,15,3,1,1.38744688794467
"972","favs",11,14,3,1,1.29495042874836
"973","february",11,14,3,1,1.29495042874836
"974","fed",9,12,3,1,1.10995751035574
"975","feedback",4,7,3,1,0.647475214374182
"976","feel",269,371,102,1156,1.0092995988774
"977","feeling",17,26,9,9,0.801635979701368
"978","feelings",9,12,3,1,1.10995751035574
"979","feels",41,59,18,36,0.909548515430398
"980","felt",59,83,24,64,0.959650764161733
"981","female",19,28,9,9,0.863300285832242
"982","fermated",4,7,3,1,0.647475214374182
"983","fermented",4,7,3,1,0.647475214374182
"984","fewer",3,6,3,1,0.55497875517787
"985","fiber",9,12,3,1,1.10995751035574
"986","fickle",11,14,3,1,1.29495042874836
"987","field",4,7,3,1,0.647475214374182
"988","fight",4,7,3,1,0.647475214374182
"989","fighting",25,34,9,9,1.04829320422487
"990","figure",18,24,6,4,1.10995751035574
"991","fill",11,14,3,1,1.29495042874836
"992","film",4,7,3,1,0.647475214374182
"993","finally",70,94,24,64,1.08683339555666
"994","find",131,191,60,400,0.883341185324776
"995","finding",9,12,3,1,1.10995751035574
"996","fine",95,128,33,121,1.07632243428435
"997","fingernails",14,17,3,1,1.5724398063373
"998","fingers",9,12,3,1,1.10995751035574
"999","finish",19,25,6,4,1.1562057399539
"1000","finished",36,48,12,16,1.10995751035574
"1001","fire",13,19,6,4,0.878716362364961
"1002","firm",11,14,3,1,1.29495042874836
"1003","first",216,285,69,529,1.14615177699777
"1004","firstdays",4,7,3,1,0.647475214374182
"1005","fish",53,68,15,25,1.25795184506984
"1006","fit",15,21,6,4,0.971212821561272
"1007","five",9,12,3,1,1.10995751035574
"1008","fix",52,73,21,49,0.964605931618679
"1009","fixed",36,48,12,16,1.10995751035574
"1010","fixing",14,17,3,1,1.5724398063373
"1011","flair",13,19,6,4,0.878716362364961
"1012","flake",9,12,3,1,1.10995751035574
"1013","flakes",8,14,6,4,0.647475214374182
"1014","flaking",4,7,3,1,0.647475214374182
"1015","flakingpeeling",9,12,3,1,1.10995751035574
"1016","flaky",4,7,3,1,0.647475214374182
"1017","flare",27,36,9,9,1.10995751035574
"1018","flared",18,24,6,4,1.10995751035574
"1019","flintstones",4,7,3,1,0.647475214374182
"1020","flowing",9,12,3,1,1.10995751035574
"1021","fluctuate",6,9,3,1,0.832468132766805
"1022","fluctuations",9,12,3,1,1.10995751035574
"1023","fluids",17,20,3,1,1.84992918392623
"1024","foaming",4,7,3,1,0.647475214374182
"1025","focus",36,48,12,16,1.10995751035574
"1026","folded",9,12,3,1,1.10995751035574
"1027","follicular",4,7,3,1,0.647475214374182
"1028","folliculitis",7,10,3,1,0.924964591963116
"1029","follow",15,21,6,4,0.971212821561272
"1030","followed",23,29,6,4,1.34119865834652
"1031","following",9,12,3,1,1.10995751035574
"1032","food",127,169,42,196,1.11656440029833
"1033","foods",108,153,45,225,0.943463883802379
"1034","fora",11,14,3,1,1.29495042874836
"1035","forehead",92,128,36,144,0.986628898093991
"1036","foremost",4,7,3,1,0.647475214374182
"1037","forever",14,17,3,1,1.5724398063373
"1038","forevers",11,14,3,1,1.29495042874836
"1039","forget",17,20,3,1,1.84992918392623
"1040","forgone",4,7,3,1,0.647475214374182
"1041","forgot",18,24,6,4,1.10995751035574
"1042","form",44,59,15,25,1.09145821851648
"1043","formating",9,12,3,1,1.10995751035574
"1044","formed",4,7,3,1,0.647475214374182
"1045","forming",9,12,3,1,1.10995751035574
"1046","forminutes",9,12,3,1,1.10995751035574
"1047","formonths",17,26,9,9,0.801635979701368
"1048","forms",4,7,3,1,0.647475214374182
"1049","formula",24,33,9,9,1.01746105115943
"1050","formulated",4,7,3,1,0.647475214374182
"1051","forseconds",3,6,3,1,0.55497875517787
"1052","forte",15,21,6,4,0.971212821561272
"1053","fortunate",9,12,3,1,1.10995751035574
"1054","forweeks",17,26,9,9,0.801635979701368
"1055","foryears",40,55,15,25,1.01746105115943
"1056","found",162,216,54,324,1.10995751035574
"1057","foundation",68,89,21,49,1.17602640978168
"1058","four",16,22,6,4,1.01746105115943
"1059","fox",4,7,3,1,0.647475214374182
"1060","freaking",13,19,6,4,0.878716362364961
"1061","free",82,115,33,121,0.967008437052349
"1062","frequently",30,42,12,16,0.971212821561272
"1063","freshly",9,12,3,1,1.10995751035574
"1064","friend",15,21,6,4,0.971212821561272
"1065","friends",45,63,18,36,0.971212821561272
"1066","fromtoaccutane",12,15,3,1,1.38744688794467
"1067","front",4,7,3,1,0.647475214374182
"1068","fruits",9,12,3,1,1.10995751035574
"1069","fuck",12,15,3,1,1.38744688794467
"1070","fucked",28,34,6,4,1.5724398063373
"1071","fucking",22,31,9,9,0.955796745028554
"1072","fucks",9,12,3,1,1.10995751035574
"1073","fueled",11,14,3,1,1.29495042874836
"1074","full",26,41,15,25,0.758470965409755
"1075","fully",4,7,3,1,0.647475214374182
"1076","fungal",49,64,15,25,1.18395467771279
"1077","fungi",15,21,6,4,0.971212821561272
"1078","future",4,7,3,1,0.647475214374182
"1079","g",8,14,6,4,0.647475214374182
"1080","gain",4,7,3,1,0.647475214374182
"1081","gallons",4,7,3,1,0.647475214374182
"1082","gamble",4,7,3,1,0.647475214374182
"1083","game",4,7,3,1,0.647475214374182
"1084","garbage",9,12,3,1,1.10995751035574
"1085","garden",4,7,3,1,0.647475214374182
"1086","garnier",42,57,15,25,1.05445963483795
"1087","gave",38,47,9,9,1.44911119407555
"1088","gee",4,7,3,1,0.647475214374182
"1089","gel",180,240,60,400,1.10995751035574
"1090","general",17,20,3,1,1.84992918392623
"1091","generally",4,7,3,1,0.647475214374182
"1092","generic",4,7,3,1,0.647475214374182
"1093","genetic",4,7,3,1,0.647475214374182
"1094","genius",11,14,3,1,1.29495042874836
"1095","gentle",77,101,24,64,1.16776779735343
"1096","gently",9,12,3,1,1.10995751035574
"1098","gets",78,108,30,100,0.998961759320166
"1100","gettinghours",4,7,3,1,0.647475214374182
"1101","gigantic",9,12,3,1,1.10995751035574
"1102","gimmicky",14,17,3,1,1.5724398063373
"1103","girl",33,51,18,36,0.786219903168649
"1104","girlfriend",11,14,3,1,1.29495042874836
"1105","girls",26,32,6,4,1.47994334714099
"1106","give",159,213,54,324,1.09454143382302
"1107","giveer",7,10,3,1,0.924964591963116
"1108","givenof",4,7,3,1,0.647475214374182
"1109","gives",8,14,6,4,0.647475214374182
"1110","giving",40,55,15,25,1.01746105115943
"1111","glad",32,47,15,25,0.869466716445329
"1112","glow",4,7,3,1,0.647475214374182
"1113","gluten",35,50,15,25,0.924964591963116
"1114","glycolic",65,83,18,36,1.27953435221564
"1115","glycoloic",18,24,6,4,1.10995751035574
"1117","goat",4,7,3,1,0.647475214374182
"1118","goats",33,42,9,9,1.29495042874836
"1119","god",21,27,6,4,1.24870219915021
"1120","goes",35,53,18,36,0.817052056234086
"1121","going",226,313,87,841,0.998323852705019
"1122","gone",80,116,36,144,0.894132438897679
"1123","gonna",46,64,18,36,0.986628898093991
"1125","goodluck",4,7,3,1,0.647475214374182
"1126","goodmonths",4,7,3,1,0.647475214374182
"1127","goods",11,14,3,1,1.29495042874836
"1128","google",20,29,9,9,0.894132438897679
"1129","googling",11,14,3,1,1.29495042874836
"1130","gosh",14,17,3,1,1.5724398063373
"1131","got",189,273,84,784,0.901840477164038
"1132","goto",4,7,3,1,0.647475214374182
"1133","gotta",31,37,6,4,1.71118449513177
"1134","gotten",22,31,9,9,0.955796745028554
"1135","grade",13,19,6,4,0.878716362364961
"1136","gradually",13,19,6,4,0.878716362364961
"1137","grail",20,26,6,4,1.20245396955205
"1138","grain",9,12,3,1,1.10995751035574
"1139","grains",17,20,3,1,1.84992918392623
"1140","grammar",9,12,3,1,1.10995751035574
"1141","grand",17,20,3,1,1.84992918392623
"1142","grease",4,7,3,1,0.647475214374182
"1143","greasy",26,38,12,16,0.878716362364961
"1144","great",100,136,36,144,1.04829320422487
"1145","greatest",4,7,3,1,0.647475214374182
"1146","green",46,61,15,25,1.128456802195
"1147","grin",17,20,3,1,1.84992918392623
"1148","gross",4,7,3,1,0.647475214374182
"1149","ground",4,7,3,1,0.647475214374182
"1150","grow",18,21,3,1,1.94242564312254
"1151","grows",11,14,3,1,1.29495042874836
"1152","guarantee",14,17,3,1,1.5724398063373
"1153","guess",12,15,3,1,1.38744688794467
"1154","guide",9,12,3,1,1.10995751035574
"1155","gummy",9,12,3,1,1.10995751035574
"1156","gusta",11,14,3,1,1.29495042874836
"1157","gut",46,64,18,36,0.986628898093991
"1158","guy",48,63,15,25,1.16545538587353
"1159","guys",30,42,12,16,0.971212821561272
"1160","gym",4,7,3,1,0.647475214374182
"1161","gyno",4,7,3,1,0.647475214374182
"1162","habit",4,7,3,1,0.647475214374182
"1163","habitpick",14,17,3,1,1.5724398063373
"1164","habits",9,12,3,1,1.10995751035574
"1165","hada",27,36,9,9,1.10995751035574
"1166","hadve",4,7,3,1,0.647475214374182
"1167","haha",26,35,9,9,1.0791253572903
"1168","hahahah",11,14,3,1,1.29495042874836
"1169","hair",57,81,24,64,0.936526649362655
"1170","hairs",28,34,6,4,1.5724398063373
"1171","half",83,113,30,100,1.04520998891832
"1172","halloween",11,14,3,1,1.29495042874836
"1173","ham",12,15,3,1,1.38744688794467
"1174","handle",4,7,3,1,0.647475214374182
"1175","hands",18,27,9,9,0.832468132766805
"1176","happen",13,19,6,4,0.878716362364961
"1177","happened",31,43,12,16,0.99433693636035
"1178","happening",9,12,3,1,1.10995751035574
"1179","happens",34,52,18,36,0.801635979701368
"1180","happiness",17,20,3,1,1.84992918392623
"1181","happy",77,107,30,100,0.989712113400535
"1182","harassed",4,7,3,1,0.647475214374182
"1183","harassing",4,7,3,1,0.647475214374182
"1184","harbor",4,7,3,1,0.647475214374182
"1185","hard",111,153,42,196,1.01085416121683
"1186","hardly",13,19,6,4,0.878716362364961
"1187","harm",11,20,9,9,0.616643061308744
"1188","harmful",4,7,3,1,0.647475214374182
"1189","harsh",60,87,27,81,0.894132438897679
"1190","hasnt",4,7,3,1,0.647475214374182
"1191","hat",31,37,6,4,1.71118449513177
"1192","hate",39,57,18,36,0.878716362364961
"1193","hatred",7,10,3,1,0.924964591963116
"1194","hats",9,12,3,1,1.10995751035574
"1195","havecleared",4,7,3,1,0.647475214374182
"1196","havent",115,160,45,225,0.986628898093991
"1197","havethat",9,12,3,1,1.10995751035574
"1198","havoc",9,12,3,1,1.10995751035574
"1199","hazel",4,7,3,1,0.647475214374182
"1200","hd",11,14,3,1,1.29495042874836
"1201","head",9,12,3,1,1.10995751035574
"1202","heads",13,19,6,4,0.878716362364961
"1203","heal",74,101,27,81,1.03801581986972
"1204","healing",52,70,18,36,1.0791253572903
"1205","heals",3,6,3,1,0.55497875517787
"1206","health",82,109,27,81,1.12023489471089
"1207","healthier",9,12,3,1,1.10995751035574
"1208","healthily",9,12,3,1,1.10995751035574
"1209","healthy",45,60,15,25,1.10995751035574
"1210","healthyvegetarian",9,12,3,1,1.10995751035574
"1211","hear",13,19,6,4,0.878716362364961
"1212","heard",90,120,30,100,1.10995751035574
"1213","heardyou",4,7,3,1,0.647475214374182
"1214","hearing",11,14,3,1,1.29495042874836
"1215","heat",45,60,15,25,1.10995751035574
"1216","heavily",27,36,9,9,1.10995751035574
"1217","heavy",11,14,3,1,1.29495042874836
"1218","heavyset",18,21,3,1,1.94242564312254
"1219","helenes",4,7,3,1,0.647475214374182
"1220","hell",33,45,12,16,1.04058516595851
"1221","hellish",4,7,3,1,0.647475214374182
"1222","hello",18,24,6,4,1.10995751035574
"1223","help",460,631,171,3249,1.02395203075215
"1224","helped",169,253,84,784,0.835771577738102
"1225","helpful",43,61,18,36,0.940380668495835
"1226","helping",4,7,3,1,0.647475214374182
"1227","helpless",8,14,6,4,0.647475214374182
"1228","helps",224,320,96,1024,0.924964591963116
"1229","hence",4,7,3,1,0.647475214374182
"1230","herbal",8,14,6,4,0.647475214374182
"1231","heres",15,21,6,4,0.971212821561272
"1232","hesitate",12,15,3,1,1.38744688794467
"1233","hey",16,22,6,4,1.01746105115943
"1234","hg",11,14,3,1,1.29495042874836
"1235","hi",44,59,15,25,1.09145821851648
"1236","hibiclens",11,17,6,4,0.786219903168649
"1237","high",56,83,27,81,0.853022901477096
"1238","higher",35,47,12,16,1.08683339555666
"1239","highlighter",4,7,3,1,0.647475214374182
"1240","highlighting",4,7,3,1,0.647475214374182
"1241","highly",73,97,24,64,1.12151956775528
"1242","hip",11,14,3,1,1.29495042874836
"1243","hit",13,19,6,4,0.878716362364961
"1244","hmm",8,14,6,4,0.647475214374182
"1245","hold",27,39,12,16,0.901840477164038
"1246","holding",4,7,3,1,0.647475214374182
"1247","holds",9,12,3,1,1.10995751035574
"1248","hole",18,21,3,1,1.94242564312254
"1249","holidays",4,7,3,1,0.647475214374182
"1250","holy",29,38,9,9,1.17162181648661
"1251","home",21,33,12,16,0.763095788369571
"1252","homeas",4,7,3,1,0.647475214374182
"1253","homemade",13,19,6,4,0.878716362364961
"1254","honest",4,7,3,1,0.647475214374182
"1255","honestly",61,94,33,121,0.790424287677572
"1256","hope",152,212,60,400,0.980462467480903
"1257","hopefully",33,45,12,16,1.04058516595851
"1258","hoping",32,44,12,16,1.01746105115943
"1259","hormonal",199,286,87,841,0.912206459660177
"1260","hormonali",17,20,3,1,1.84992918392623
"1261","hormonalit",4,7,3,1,0.647475214374182
"1262","hormonallower",4,7,3,1,0.647475214374182
"1263","hormone",47,62,15,25,1.14695609403426
"1264","hormones",114,153,39,169,1.08861217361813
"1265","horrendous",4,7,3,1,0.647475214374182
"1266","horrible",9,15,6,4,0.693723443972337
"1267","horribly",9,12,3,1,1.10995751035574
"1268","horrific",4,7,3,1,0.647475214374182
"1269","horror",6,9,3,1,0.832468132766805
"1270","hot",9,12,3,1,1.10995751035574
"1271","hours",3,6,3,1,0.55497875517787
"1272","however",52,70,18,36,1.0791253572903
"1273","hows",4,7,3,1,0.647475214374182
"1274","hp",14,17,3,1,1.5724398063373
"1275","hr",4,7,3,1,0.647475214374182
"1276","hs",4,7,3,1,0.647475214374182
"1277","huge",56,77,21,49,1.01746105115943
"1278","human",26,32,6,4,1.47994334714099
"1279","hunt",11,14,3,1,1.29495042874836
"1280","hurt",40,58,18,36,0.894132438897679
"1281","hurtburn",18,24,6,4,1.10995751035574
"1282","hurtful",7,10,3,1,0.924964591963116
"1283","hurting",14,17,3,1,1.5724398063373
"1284","hurts",9,12,3,1,1.10995751035574
"1285","hyaluronic",27,36,9,9,1.10995751035574
"1286","hydra",11,14,3,1,1.29495042874836
"1287","hydrated",34,46,12,16,1.06370928075758
"1288","hydrating",29,47,18,36,0.724555597037775
"1289","hydro",18,24,6,4,1.10995751035574
"1290","hydrocoil",11,14,3,1,1.29495042874836
"1291","hydrocolloid",18,24,6,4,1.10995751035574
"1292","hydrocortisone",14,17,3,1,1.5724398063373
"1293","hygienic",11,14,3,1,1.29495042874836
"1294","hylaruic",4,7,3,1,0.647475214374182
"1295","hyperkalemia",9,12,3,1,1.10995751035574
"1296","hyperpigmentation",48,60,12,16,1.38744688794467
"1297","hypersensitive",4,7,3,1,0.647475214374182
"1298","hypokalemia",9,12,3,1,1.10995751035574
"1299","i️",41,68,27,81,0.69886213614991
"1300","ib",18,24,6,4,1.10995751035574
"1301","ibuprofen",4,7,3,1,0.647475214374182
"1302","iburofen",4,7,3,1,0.647475214374182
"1303","ice",46,64,18,36,0.986628898093991
"1304","icing",4,7,3,1,0.647475214374182
"1305","id",157,223,66,484,0.937577745489886
"1306","idea",27,36,9,9,1.10995751035574
"1307","ideas",9,12,3,1,1.10995751035574
"1308","identical",14,17,3,1,1.5724398063373
"1309","idk",49,67,18,36,1.03287712769215
"1310","ie",4,7,3,1,0.647475214374182
"1311","iffy",11,14,3,1,1.29495042874836
"1312","igf",9,12,3,1,1.10995751035574
"1313","il",12,15,3,1,1.38744688794467
"1314","ill",66,90,24,64,1.04058516595851
"1316","image",9,12,3,1,1.10995751035574
"1317","imagine",15,18,3,1,1.66493626553361
"1318","imagining",9,12,3,1,1.10995751035574
"1319","imand",15,21,6,4,0.971212821561272
"1320","imbalance",8,14,6,4,0.647475214374182
"1321","imbalances",9,12,3,1,1.10995751035574
"1322","immediate",3,6,3,1,0.55497875517787
"1323","immediately",27,33,6,4,1.52619157673914
"1324","immensely",9,12,3,1,1.10995751035574
"1325","immonths",4,7,3,1,0.647475214374182
"1326","immune",18,21,3,1,1.94242564312254
"1327","imo",32,47,15,25,0.869466716445329
"1328","impact",45,57,12,16,1.31807454354744
"1329","imperfection",8,11,3,1,1.01746105115943
"1330","imperialis",11,14,3,1,1.29495042874836
"1331","important",46,61,15,25,1.128456802195
"1332","importantdrink",9,12,3,1,1.10995751035574
"1333","improper",11,14,3,1,1.29495042874836
"1334","improve",7,13,6,4,0.601226984776026
"1335","improved",9,12,3,1,1.10995751035574
"1336","improvement",64,88,24,64,1.01746105115943
"1337","improvements",4,7,3,1,0.647475214374182
"1338","improving",15,18,3,1,1.66493626553361
"1339","impurities",15,18,3,1,1.66493626553361
"1340","imso",3,6,3,1,0.55497875517787
"1341","imtoo",9,12,3,1,1.10995751035574
"1342","inand",4,7,3,1,0.647475214374182
"1343","inb",9,12,3,1,1.10995751035574
"1344","include",4,7,3,1,0.647475214374182
"1345","included",4,7,3,1,0.647475214374182
"1346","includes",9,12,3,1,1.10995751035574
"1347","including",20,26,6,4,1.20245396955205
"1348","incompetent",9,12,3,1,1.10995751035574
"1349","incorporate",4,7,3,1,0.647475214374182
"1350","increase",21,33,12,16,0.763095788369571
"1351","increases",29,38,9,9,1.17162181648661
"1352","increasing",4,7,3,1,0.647475214374182
"1353","indent",9,12,3,1,1.10995751035574
"1354","indenticepick",4,7,3,1,0.647475214374182
"1355","indents",9,12,3,1,1.10995751035574
"1356","indicated",4,7,3,1,0.647475214374182
"1357","indirect",9,12,3,1,1.10995751035574
"1358","individual",4,7,3,1,0.647475214374182
"1359","individualized",9,12,3,1,1.10995751035574
"1360","induced",4,7,3,1,0.647475214374182
"1361","inexpensive",4,7,3,1,0.647475214374182
"1362","inexplicable",4,7,3,1,0.647475214374182
"1363","infection",11,17,6,4,0.786219903168649
"1364","inflamed",4,7,3,1,0.647475214374182
"1365","inflammation",36,45,9,9,1.38744688794467
"1366","inflammations",9,12,3,1,1.10995751035574
"1367","info",29,38,9,9,1.17162181648661
"1368","information",4,7,3,1,0.647475214374182
"1369","ingredient",43,58,15,25,1.07295892667722
"1370","ingredients",83,116,33,121,0.975417206070195
"1371","ingredientsrecommended",11,14,3,1,1.29495042874836
"1372","inherited",9,12,3,1,1.10995751035574
"1373","initially",9,12,3,1,1.10995751035574
"1374","injected",4,7,3,1,0.647475214374182
"1375","injection",4,7,3,1,0.647475214374182
"1376","inquiring",9,12,3,1,1.10995751035574
"1377","insecurities",13,19,6,4,0.878716362364961
"1378","inside",27,36,9,9,1.10995751035574
"1379","insight",4,7,3,1,0.647475214374182
"1380","instead",79,109,30,100,1.0082114052398
"1381","insteadnot",14,17,3,1,1.5724398063373
"1382","instrument",4,7,3,1,0.647475214374182
"1383","insurance",9,12,3,1,1.10995751035574
"1384","intake",19,28,9,9,0.863300285832242
"1385","interested",10,16,6,4,0.739971673570493
"1386","interesting",4,7,3,1,0.647475214374182
"1387","internal",28,37,9,9,1.14078966342118
"1388","internally",9,12,3,1,1.10995751035574
"1389","intothen",9,12,3,1,1.10995751035574
"1390","introduce",4,7,3,1,0.647475214374182
"1391","introducing",9,12,3,1,1.10995751035574
"1392","invest",22,31,9,9,0.955796745028554
"1393","invested",9,12,3,1,1.10995751035574
"1394","invisible",11,14,3,1,1.29495042874836
"1395","inweeks",9,12,3,1,1.10995751035574
"1396","ior",4,7,3,1,0.647475214374182
"1397","iron",4,7,3,1,0.647475214374182
"1398","ironically",11,14,3,1,1.29495042874836
"1399","irregular",24,30,6,4,1.38744688794467
"1400","irrelevant",4,7,3,1,0.647475214374182
"1401","irritant",11,14,3,1,1.29495042874836
"1402","irritate",22,34,12,16,0.786219903168649
"1403","irritated",24,33,9,9,1.01746105115943
"1404","irritating",56,83,27,81,0.853022901477096
"1405","irritatingpeeling",9,12,3,1,1.10995751035574
"1406","irritation",33,54,21,49,0.713544113800118
"1407","irritations",17,20,3,1,1.84992918392623
"1408","isand",22,28,6,4,1.29495042874836
"1409","isbased",12,15,3,1,1.38744688794467
"1410","isgood",17,20,3,1,1.84992918392623
"1411","ish",27,33,6,4,1.52619157673914
"1412","islets",9,12,3,1,1.10995751035574
"1413","isliters",15,18,3,1,1.66493626553361
"1414","ismonths",11,14,3,1,1.29495042874836
"1415","isnt",119,164,45,225,1.01129462054634
"1416","isotretinoin",15,21,6,4,0.971212821561272
"1417","isotretinoinright",17,20,3,1,1.84992918392623
"1418","issue",67,91,24,64,1.05214722335804
"1419","issues",4,7,3,1,0.647475214374182
"1420","itbut",7,10,3,1,0.924964591963116
"1421","itchy",4,7,3,1,0.647475214374182
"1422","itd",13,16,3,1,1.47994334714099
"1423","items",14,17,3,1,1.5724398063373
"1424","itll",60,84,24,64,0.971212821561272
"1425","itsbenzoyl",9,12,3,1,1.10995751035574
"1426","itthere",11,14,3,1,1.29495042874836
"1427","ittimes",4,7,3,1,0.647475214374182
"1428","iv",4,7,3,1,0.647475214374182
"1430","ives",14,17,3,1,1.5724398063373
"1431","ivory",11,14,3,1,1.29495042874836
"1432","jack",9,12,3,1,1.10995751035574
"1433","januaryof",4,7,3,1,0.647475214374182
"1434","jaw",15,18,3,1,1.66493626553361
"1435","jawline",16,28,12,16,0.647475214374182
"1436","jaws",9,12,3,1,1.10995751035574
"1437","jealous",28,37,9,9,1.14078966342118
"1438","jeans",18,21,3,1,1.94242564312254
"1439","jist",18,24,6,4,1.10995751035574
"1440","job",20,29,9,9,0.894132438897679
"1441","joints",4,7,3,1,0.647475214374182
"1442","jojoba",22,31,9,9,0.955796745028554
"1443","jokes",6,9,3,1,0.832468132766805
"1444","judgements",4,7,3,1,0.647475214374182
"1445","juice",44,53,9,9,1.63410411246817
"1446","juicegood",4,7,3,1,0.647475214374182
"1447","juicing",29,35,6,4,1.61868803593545
"1448","julep",4,7,3,1,0.647475214374182
"1449","jump",8,14,6,4,0.647475214374182
"1450","jumping",9,12,3,1,1.10995751035574
"1451","june",26,32,6,4,1.47994334714099
"1452","junior",4,7,3,1,0.647475214374182
"1453","junk",17,20,3,1,1.84992918392623
"1455","k",4,7,3,1,0.647475214374182
"1456","kate",14,17,3,1,1.5724398063373
"1457","keep",239,320,81,729,1.09625433121555
"1458","keeping",33,45,12,16,1.04058516595851
"1459","keeps",11,14,3,1,1.29495042874836
"1460","kept",8,14,6,4,0.647475214374182
"1461","ketoconazole",11,14,3,1,1.29495042874836
"1462","key",13,19,6,4,0.878716362364961
"1463","kg",4,7,3,1,0.647475214374182
"1464","kick",4,7,3,1,0.647475214374182
"1465","kids",15,21,6,4,0.971212821561272
"1466","kill",11,14,3,1,1.29495042874836
"1467","kind",103,139,36,144,1.07141731902394
"1468","kinda",26,38,12,16,0.878716362364961
"1469","kinds",22,31,9,9,0.955796745028554
"1470","kisses",11,14,3,1,1.29495042874836
"1471","kit",11,14,3,1,1.29495042874836
"1472","kitchen",9,12,3,1,1.10995751035574
"1473","knew",15,21,6,4,0.971212821561272
"1474","know",314,452,138,2116,0.908878251233323
"1475","knowing",4,7,3,1,0.647475214374182
"1476","knowledge",14,17,3,1,1.5724398063373
"1477","known",24,33,9,9,1.01746105115943
"1478","knows",8,14,6,4,0.647475214374182
"1479","kombucha",34,43,9,9,1.3257825818138
"1480","kombutcha",4,7,3,1,0.647475214374182
"1481","korean",20,26,6,4,1.20245396955205
"1482","kumbucha",18,24,6,4,1.10995751035574
"1483","la",24,33,9,9,1.01746105115943
"1484","labo",18,24,6,4,1.10995751035574
"1485","labor",9,12,3,1,1.10995751035574
"1486","lack",14,17,3,1,1.5724398063373
"1487","lacking",15,21,6,4,0.971212821561272
"1488","lactic",14,17,3,1,1.5724398063373
"1489","ladies",18,24,6,4,1.10995751035574
"1490","lady",18,24,6,4,1.10995751035574
"1491","lard",13,16,3,1,1.47994334714099
"1492","laser",35,50,15,25,0.924964591963116
"1493","last",89,119,30,100,1.10070786443611
"1494","lasted",4,7,3,1,0.647475214374182
"1495","lasts",11,14,3,1,1.29495042874836
"1496","latch",11,14,3,1,1.29495042874836
"1497","late",8,14,6,4,0.647475214374182
"1498","later",50,71,21,49,0.938178371848304
"1499","lavender",17,20,3,1,1.84992918392623
"1500","layer",23,29,6,4,1.34119865834652
"1501","layers",4,7,3,1,0.647475214374182
"1502","lazy",21,27,6,4,1.24870219915021
"1503","lead",17,26,9,9,0.801635979701368
"1504","leads",4,7,3,1,0.647475214374182
"1505","learn",4,7,3,1,0.647475214374182
"1506","learned",13,19,6,4,0.878716362364961
"1507","learnt",14,20,6,4,0.924964591963116
"1508","least",92,131,39,169,0.932079704208987
"1509","leastcystic",4,7,3,1,0.647475214374182
"1510","leave",31,46,15,25,0.850967424606067
"1511","leaves",4,7,3,1,0.647475214374182
"1512","leaving",13,19,6,4,0.878716362364961
"1513","left",46,64,18,36,0.986628898093991
"1514","lemon",29,35,6,4,1.61868803593545
"1515","lengthways",9,12,3,1,1.10995751035574
"1516","less",100,142,42,196,0.938178371848304
"1517","let",58,85,27,81,0.873577670187388
"1518","level",20,26,6,4,1.20245396955205
"1519","levels",45,63,18,36,0.971212821561272
"1520","lie",4,7,3,1,0.647475214374182
"1521","life",154,205,51,289,1.11539847854376
"1522","lifestyle",35,50,15,25,0.924964591963116
"1523","lifting",8,14,6,4,0.647475214374182
"1524","light",79,100,21,49,1.32137798851874
"1525","lighting",21,27,6,4,1.24870219915021
"1526","lightly",36,48,12,16,1.10995751035574
"1527","lightweight",11,14,3,1,1.29495042874836
"1529","likebucks",4,7,3,1,0.647475214374182
"1530","liked",11,14,3,1,1.29495042874836
"1531","likehours",12,15,3,1,1.38744688794467
"1532","likely",25,40,15,25,0.739971673570493
"1533","likemonths",18,24,6,4,1.10995751035574
"1534","likemy",4,7,3,1,0.647475214374182
"1535","likeof",4,7,3,1,0.647475214374182
"1536","likeyears",18,24,6,4,1.10995751035574
"1537","limit",9,12,3,1,1.10995751035574
"1538","limited",22,28,6,4,1.29495042874836
"1539","line",48,63,15,25,1.16545538587353
"1540","lines",15,18,3,1,1.66493626553361
"1541","link",4,7,3,1,0.647475214374182
"1542","linked",9,12,3,1,1.10995751035574
"1543","linking",12,15,3,1,1.38744688794467
"1544","lip",62,80,18,36,1.23328612261749
"1545","lips",17,26,9,9,0.801635979701368
"1546","lipsliterally",11,14,3,1,1.29495042874836
"1547","liquid",29,38,9,9,1.17162181648661
"1548","list",19,25,6,4,1.1562057399539
"1549","listed",18,24,6,4,1.10995751035574
"1550","listen",4,7,3,1,0.647475214374182
"1551","literally",35,47,12,16,1.08683339555666
"1552","little",85,127,42,196,0.839075022709398
"1553","live",53,74,21,49,0.977819711503866
"1554","liver",68,86,18,36,1.3257825818138
"1555","living",26,32,6,4,1.47994334714099
"1556","lmao",4,7,3,1,0.647475214374182
"1557","lo",4,7,3,1,0.647475214374182
"1558","loads",13,19,6,4,0.878716362364961
"1559","loathe",4,7,3,1,0.647475214374182
"1560","locacid",9,12,3,1,1.10995751035574
"1561","located",4,7,3,1,0.647475214374182
"1562","lol",61,82,21,49,1.08352995058536
"1563","long",157,217,60,400,1.00358658227998
"1564","longest",4,7,3,1,0.647475214374182
"1565","look",192,267,75,625,0.987862184216608
"1566","looked",72,93,21,49,1.22888152932243
"1567","looking",89,119,30,100,1.10070786443611
"1568","looks",180,249,69,529,1.00137471042963
"1569","loose",11,14,3,1,1.29495042874836
"1570","loreal",11,14,3,1,1.29495042874836
"1571","loréal",11,14,3,1,1.29495042874836
"1572","loss",14,23,9,9,0.709139520505056
"1573","lost",6,9,3,1,0.832468132766805
"1575","lotion",74,107,33,121,0.899738284909577
"1576","lotions",4,7,3,1,0.647475214374182
"1577","lots",87,114,27,81,1.17162181648661
"1578","love",87,114,27,81,1.17162181648661
"1579","lovely",9,12,3,1,1.10995751035574
"1580","loves",30,39,9,9,1.20245396955205
"1581","low",35,50,15,25,0.924964591963116
"1582","lowcut",4,7,3,1,0.647475214374182
"1583","lower",13,22,9,9,0.678307367439619
"1584","lowering",4,7,3,1,0.647475214374182
"1585","lowers",4,7,3,1,0.647475214374182
"1586","luck",313,415,102,1156,1.1290008990138
"1587","lucky",12,21,9,9,0.647475214374182
"1588","luckymine",9,12,3,1,1.10995751035574
"1589","lunches",4,7,3,1,0.647475214374182
"1590","lush",15,21,6,4,0.971212821561272
"1591","lying",16,19,3,1,1.75743272472992
"1592","lymecycline",20,35,15,25,0.647475214374182
"1593","mad",9,12,3,1,1.10995751035574
"1594","made",178,253,75,625,0.936064167066674
"1595","magic",9,12,3,1,1.10995751035574
"1596","magical",9,12,3,1,1.10995751035574
"1597","magnesia",4,7,3,1,0.647475214374182
"1598","magnesium",21,27,6,4,1.24870219915021
"1599","main",20,26,6,4,1.20245396955205
"1600","mainly",46,58,12,16,1.34119865834652
"1601","maintain",11,14,3,1,1.29495042874836
"1602","maintenance",6,9,3,1,0.832468132766805
"1603","major",13,19,6,4,0.878716362364961
"1605","makes",180,255,75,625,0.943463883802379
"1606","makeup",111,150,39,169,1.06726683688052
"1607","making",71,92,21,49,1.21566774943724
"1608","male",22,31,9,9,0.955796745028554
"1609","man",87,114,27,81,1.17162181648661
"1610","manage",19,28,9,9,0.863300285832242
"1611","mantra",9,12,3,1,1.10995751035574
"1612","manually",7,10,3,1,0.924964591963116
"1613","many",126,174,48,256,1.00589899375989
"1614","march",17,20,3,1,1.84992918392623
"1615","marginally",18,24,6,4,1.10995751035574
"1616","mark",15,21,6,4,0.971212821561272
"1617","market",4,7,3,1,0.647475214374182
"1618","marks",36,57,21,49,0.753185453455681
"1619","mask",71,98,27,81,1.00718366680428
"1620","masks",17,26,9,9,0.801635979701368
"1621","massaged",9,12,3,1,1.10995751035574
"1622","massive",19,25,6,4,1.1562057399539
"1623","matte",34,43,9,9,1.3257825818138
"1624","matter",53,77,24,64,0.8902784197645
"1625","matters",4,7,3,1,0.647475214374182
"1626","mattifier",4,7,3,1,0.647475214374182
"1627","mattifyingthose",11,14,3,1,1.29495042874836
"1628","max",9,12,3,1,1.10995751035574
"1630","maybe",181,250,69,529,1.00539629561208
"1631","maybelline",22,28,6,4,1.29495042874836
"1632","meal",24,33,9,9,1.01746105115943
"1633","mean",51,66,15,25,1.22095326139131
"1634","meand",14,17,3,1,1.5724398063373
"1635","meaning",4,7,3,1,0.647475214374182
"1636","means",57,78,21,49,1.03067483104462
"1637","meant",15,21,6,4,0.971212821561272
"1638","meantime",11,14,3,1,1.29495042874836
"1639","measurably",4,7,3,1,0.647475214374182
"1640","meat",19,25,6,4,1.1562057399539
"1641","meatless",9,12,3,1,1.10995751035574
"1642","mebeen",4,7,3,1,0.647475214374182
"1643","med",4,7,3,1,0.647475214374182
"1644","medical",50,68,18,36,1.04829320422487
"1645","medicalgrade",7,10,3,1,0.924964591963116
"1646","medication",57,81,24,64,0.936526649362655
"1647","medications",17,26,9,9,0.801635979701368
"1648","medicine",15,21,6,4,0.971212821561272
"1649","medicines",4,7,3,1,0.647475214374182
"1650","medium",17,20,3,1,1.84992918392623
"1651","meds",4,7,3,1,0.647475214374182
"1652","medsit",4,7,3,1,0.647475214374182
"1653","melasmapca",4,7,3,1,0.647475214374182
"1654","memories",17,20,3,1,1.84992918392623
"1655","memy",17,20,3,1,1.84992918392623
"1656","menstrual",4,7,3,1,0.647475214374182
"1657","mental",32,47,15,25,0.869466716445329
"1658","mentally",4,7,3,1,0.647475214374182
"1659","mention",20,26,6,4,1.20245396955205
"1660","mentioned",9,12,3,1,1.10995751035574
"1661","mentionned",4,7,3,1,0.647475214374182
"1662","mentions",9,12,3,1,1.10995751035574
"1663","mess",13,19,6,4,0.878716362364961
"1664","message",11,14,3,1,1.29495042874836
"1665","metformin",8,14,6,4,0.647475214374182
"1666","method",9,12,3,1,1.10995751035574
"1667","methods",13,16,3,1,1.47994334714099
"1668","meyo",9,12,3,1,1.10995751035574
"1669","meyoftlbs",4,7,3,1,0.647475214374182
"1670","meyrs",4,7,3,1,0.647475214374182
"1671","mg",36,54,18,36,0.832468132766805
"1672","mgtimes",9,12,3,1,1.10995751035574
"1673","micellar",37,52,15,25,0.961963175641641
"1674","microdermabrasion",45,54,9,9,1.66493626553361
"1675","microderms",4,7,3,1,0.647475214374182
"1676","microneedling",10,13,3,1,1.20245396955205
"1677","mid",9,12,3,1,1.10995751035574
"1678","middle",9,12,3,1,1.10995751035574
"1680","mightnt",4,7,3,1,0.647475214374182
"1681","mightve",4,7,3,1,0.647475214374182
"1682","mild",76,103,27,81,1.05857058858001
"1683","mildly",4,7,3,1,0.647475214374182
"1684","milia",33,42,9,9,1.29495042874836
"1685","milk",69,93,24,64,1.07527133815712
"1686","milks",11,14,3,1,1.29495042874836
"1687","million",4,7,3,1,0.647475214374182
"1688","mind",41,56,15,25,1.03596034299869
"1689","mine",87,120,33,121,1.00905228214158
"1690","minejust",14,17,3,1,1.5724398063373
"1691","mineral",22,28,6,4,1.29495042874836
"1692","minerals",22,28,6,4,1.29495042874836
"1693","mines",4,7,3,1,0.647475214374182
"1694","minimal",22,28,6,4,1.29495042874836
"1695","minimize",4,7,3,1,0.647475214374182
"1696","minimized",4,7,3,1,0.647475214374182
"1697","minimizers",9,12,3,1,1.10995751035574
"1698","minimum",4,7,3,1,0.647475214374182
"1699","mino",4,7,3,1,0.647475214374182
"1700","minocycline",4,7,3,1,0.647475214374182
"1701","minor",4,7,3,1,0.647475214374182
"1702","mint",4,7,3,1,0.647475214374182
"1703","minty",18,24,6,4,1.10995751035574
"1704","minutes",9,12,3,1,1.10995751035574
"1705","miracle",21,27,6,4,1.24870219915021
"1706","mirror",20,26,6,4,1.20245396955205
"1707","misconception",4,7,3,1,0.647475214374182
"1708","miserable",4,7,3,1,0.647475214374182
"1709","miss",4,7,3,1,0.647475214374182
"1710","mist",11,14,3,1,1.29495042874836
"1711","mistake",6,9,3,1,0.832468132766805
"1712","mix",12,21,9,9,0.647475214374182
"1713","mixed",21,27,6,4,1.24870219915021
"1714","mixing",9,12,3,1,1.10995751035574
"1715","mixingvicks",4,7,3,1,0.647475214374182
"1716","mo",21,27,6,4,1.24870219915021
"1717","mobile",9,12,3,1,1.10995751035574
"1718","moderate",36,48,12,16,1.10995751035574
"1719","moderately",9,12,3,1,1.10995751035574
"1720","modest",4,7,3,1,0.647475214374182
"1721","modified",4,7,3,1,0.647475214374182
"1722","moist",9,12,3,1,1.10995751035574
"1723","moisture",85,115,30,100,1.06370928075758
"1724","moisturise",21,27,6,4,1.24870219915021
"1725","moisturiser",58,79,21,49,1.0438886109298
"1726","moisturising",15,21,6,4,0.971212821561272
"1727","moisturize",77,107,30,100,0.989712113400535
"1728","moisturized",26,32,6,4,1.47994334714099
"1729","moisturizer",289,394,105,1225,1.04124585495277
"1730","moisturizerdiet",9,12,3,1,1.10995751035574
"1731","moisturizers",14,17,3,1,1.5724398063373
"1732","moisturizersthey",11,14,3,1,1.29495042874836
"1733","moisturizing",41,53,12,16,1.22557808435113
"1734","molecules",9,12,3,1,1.10995751035574
"1735","mom",32,41,9,9,1.26411827568293
"1736","moment",17,20,3,1,1.84992918392623
"1737","money",4,7,3,1,0.647475214374182
"1738","monitored",12,15,3,1,1.38744688794467
"1739","monster",18,24,6,4,1.10995751035574
"1740","month",148,211,63,441,0.929369185258179
"1741","monthly",22,31,9,9,0.955796745028554
"1742","months",120,165,45,225,1.01746105115943
"1743","monthsthe",13,16,3,1,1.47994334714099
"1744","mood",18,24,6,4,1.10995751035574
"1745","moods",9,12,3,1,1.10995751035574
"1746","moral",4,7,3,1,0.647475214374182
"1747","morning",130,181,51,289,0.984815242031318
"1748","mornings",4,7,3,1,0.647475214374182
"1749","morningwash",9,12,3,1,1.10995751035574
"1750","moron",9,12,3,1,1.10995751035574
"1751","mostly",50,74,24,64,0.855592247565883
"1752","mother",13,19,6,4,0.878716362364961
"1753","motions",9,12,3,1,1.10995751035574
"1754","mountain",4,7,3,1,0.647475214374182
"1755","mouth",16,28,12,16,0.647475214374182
"1756","mouthchin",4,7,3,1,0.647475214374182
"1757","move",22,28,6,4,1.29495042874836
"1758","moved",13,19,6,4,0.878716362364961
"1759","movements",9,12,3,1,1.10995751035574
"1761","muchhhhh",18,24,6,4,1.10995751035574
"1762","muchobviously",11,14,3,1,1.29495042874836
"1763","multi",8,14,6,4,0.647475214374182
"1764","multiple",8,14,6,4,0.647475214374182
"1765","multivitamin",8,14,6,4,0.647475214374182
"1766","multivitamins",4,7,3,1,0.647475214374182
"1767","mum",16,28,12,16,0.647475214374182
"1768","murad",4,7,3,1,0.647475214374182
"1769","muscle",4,7,3,1,0.647475214374182
"1770","must",62,86,24,64,0.99433693636035
"1771","muuucch",4,7,3,1,0.647475214374182
"1772","mystep",11,14,3,1,1.29495042874836
"1773","mysterious",9,12,3,1,1.10995751035574
"1774","n",11,14,3,1,1.29495042874836
"1775","nagged",17,20,3,1,1.84992918392623
"1776","nails",33,42,9,9,1.29495042874836
"1777","name",28,37,9,9,1.14078966342118
"1778","names",11,14,3,1,1.29495042874836
"1779","nanny",4,7,3,1,0.647475214374182
"1780","nasty",8,14,6,4,0.647475214374182
"1781","natural",62,83,21,49,1.09674373047055
"1782","naturally",24,33,9,9,1.01746105115943
"1783","nauseous",4,7,3,1,0.647475214374182
"1784","naw",4,7,3,1,0.647475214374182
"1785","nazoralcream",4,7,3,1,0.647475214374182
"1786","ne",4,7,3,1,0.647475214374182
"1787","near",8,14,6,4,0.647475214374182
"1788","nearly",8,14,6,4,0.647475214374182
"1789","nearlyboy",4,7,3,1,0.647475214374182
"1790","nearlyweeks",4,7,3,1,0.647475214374182
"1791","neck",12,21,9,9,0.647475214374182
"1792","neckchest",4,7,3,1,0.647475214374182
"1793","need",243,339,96,1024,0.979884364610926
"1794","needed",27,45,18,36,0.693723443972337
"1795","needing",11,17,6,4,0.786219903168649
"1796","needle",9,12,3,1,1.10995751035574
"1797","needles",4,7,3,1,0.647475214374182
"1798","needs",34,43,9,9,1.3257825818138
"1799","neem",4,7,3,1,0.647475214374182
"1800","nervous",18,24,6,4,1.10995751035574
"1801","neutral",22,28,6,4,1.29495042874836
"1802","neutrogena",82,115,33,121,0.967008437052349
"1803","never",123,174,51,289,0.94672846471519
"1804","neverending",4,7,3,1,0.647475214374182
"1805","new",96,123,27,81,1.26411827568293
"1806","next",61,82,21,49,1.08352995058536
"1807","niacinimide",11,14,3,1,1.29495042874836
"1808","nianmicide",14,17,3,1,1.5724398063373
"1809","nice",24,33,9,9,1.01746105115943
"1810","nicely",9,12,3,1,1.10995751035574
"1811","night",240,327,87,841,1.04297731576531
"1812","nightshades",4,7,3,1,0.647475214374182
"1813","nighttime",8,14,6,4,0.647475214374182
"1814","nizoral",18,24,6,4,1.10995751035574
"1815","nobody",4,7,3,1,0.647475214374182
"1816","nodule",9,12,3,1,1.10995751035574
"1817","noncomedogenic",24,33,9,9,1.01746105115943
"1818","none",18,24,6,4,1.10995751035574
"1819","nonfoaming",8,14,6,4,0.647475214374182
"1820","nonmedicated",4,7,3,1,0.647475214374182
"1821","normal",79,109,30,100,1.0082114052398
"1822","normaldry",17,20,3,1,1.84992918392623
"1823","normally",13,19,6,4,0.878716362364961
"1824","nose",26,38,12,16,0.878716362364961
"1825","nothing",88,124,36,144,0.955796745028554
"1826","notice",40,61,21,49,0.80604057299643
"1827","noticeable",13,19,6,4,0.878716362364961
"1828","noticed",85,118,33,121,0.992234744105889
"1829","noticedthe",9,12,3,1,1.10995751035574
"1830","noticing",12,15,3,1,1.38744688794467
"1831","nottouch",4,7,3,1,0.647475214374182
"1832","nourished",11,14,3,1,1.29495042874836
"1834","nowand",9,12,3,1,1.10995751035574
"1835","nowhow",9,12,3,1,1.10995751035574
"1836","nowif",4,7,3,1,0.647475214374182
"1837","nowyears",11,14,3,1,1.29495042874836
"1838","nude",11,14,3,1,1.29495042874836
"1839","numbernow",4,7,3,1,0.647475214374182
"1840","nutrition",4,7,3,1,0.647475214374182
"1841","nuvaring",9,12,3,1,1.10995751035574
"1842","nyx",11,14,3,1,1.29495042874836
"1843","obscure",9,12,3,1,1.10995751035574
"1844","observing",14,17,3,1,1.5724398063373
"1845","obvious",9,12,3,1,1.10995751035574
"1846","obviously",42,57,15,25,1.05445963483795
"1847","oc",4,7,3,1,0.647475214374182
"1848","occasional",4,7,3,1,0.647475214374182
"1849","occasionally",40,52,12,16,1.20245396955205
"1850","occurrence",4,7,3,1,0.647475214374182
"1851","odd",4,7,3,1,0.647475214374182
"1852","offending",11,14,3,1,1.29495042874836
"1853","offer",28,37,9,9,1.14078966342118
"1854","offered",8,14,6,4,0.647475214374182
"1855","office",14,17,3,1,1.5724398063373
"1856","officer",4,7,3,1,0.647475214374182
"1857","offtimes",4,7,3,1,0.647475214374182
"1858","ofmonths",18,24,6,4,1.10995751035574
"1859","ofmy",4,7,3,1,0.647475214374182
"1860","often",76,109,33,121,0.91655582294527
"1861","ofto",4,7,3,1,0.647475214374182
"1862","oh",44,62,18,36,0.955796745028554
"1863","oil",390,549,159,2809,0.958123699976889
"1864","oilbased",9,12,3,1,1.10995751035574
"1865","oilfree",4,7,3,1,0.647475214374182
"1866","oilid",4,7,3,1,0.647475214374182
"1867","oiliness",12,18,6,4,0.832468132766805
"1868","oils",33,45,12,16,1.04058516595851
"1869","oilstrippingdrying",4,7,3,1,0.647475214374182
"1870","oily",95,146,51,289,0.794381355450676
"1871","oilygreasy",4,7,3,1,0.647475214374182
"1872","ok",15,21,6,4,0.971212821561272
"1873","okay",4,7,3,1,0.647475214374182
"1874","old",52,76,24,64,0.878716362364961
"1875","older",15,21,6,4,0.971212821561272
"1876","ollys",13,19,6,4,0.878716362364961
"1877","omega",9,12,3,1,1.10995751035574
"1878","omegaand",9,12,3,1,1.10995751035574
"1879","omegaflaxseed",9,12,3,1,1.10995751035574
"1880","omegasuppl",4,7,3,1,0.647475214374182
"1881","onand",12,15,3,1,1.38744688794467
"1882","one",410,554,144,2304,1.06756329989076
"1883","onelittle",4,7,3,1,0.647475214374182
"1884","ones",54,75,21,49,0.991033491389053
"1885","onit",4,7,3,1,0.647475214374182
"1886","online",35,50,15,25,0.924964591963116
"1887","onlymonths",4,7,3,1,0.647475214374182
"1888","onlyweeks",11,14,3,1,1.29495042874836
"1889","onmg",4,7,3,1,0.647475214374182
"1890","onto",30,45,15,25,0.832468132766805
"1891","op",8,14,6,4,0.647475214374182
"1892","open",4,7,3,1,0.647475214374182
"1893","opening",4,7,3,1,0.647475214374182
"1894","opinion",15,21,6,4,0.971212821561272
"1895","opportunities",6,9,3,1,0.832468132766805
"1896","opposed",8,14,6,4,0.647475214374182
"1897","opposite",4,7,3,1,0.647475214374182
"1898","oppositethey",9,12,3,1,1.10995751035574
"1899","option",19,25,6,4,1.1562057399539
"1900","optionaccutane",9,12,3,1,1.10995751035574
"1901","options",25,34,9,9,1.04829320422487
"1902","oral",17,26,9,9,0.801635979701368
"1903","orange",11,14,3,1,1.29495042874836
"1904","ordered",15,18,3,1,1.66493626553361
"1905","ordinary",18,24,6,4,1.10995751035574
"1906","organics",4,7,3,1,0.647475214374182
"1907","original",9,12,3,1,1.10995751035574
"1908","ortho",8,14,6,4,0.647475214374182
"1909","osun",14,17,3,1,1.5724398063373
"1910","otc",8,14,6,4,0.647475214374182
"1911","others",32,50,18,36,0.77080382663593
"1912","otherwise",8,14,6,4,0.647475214374182
"1913","ouch",4,7,3,1,0.647475214374182
"1914","outbreaks",13,19,6,4,0.878716362364961
"1915","outcome",11,14,3,1,1.29495042874836
"1916","outlook",11,14,3,1,1.29495042874836
"1917","outside",17,26,9,9,0.801635979701368
"1918","overall",15,21,6,4,0.971212821561272
"1919","overallbut",9,12,3,1,1.10995751035574
"1920","overapply",4,7,3,1,0.647475214374182
"1921","overdrive",11,14,3,1,1.29495042874836
"1922","overgrowth",4,7,3,1,0.647475214374182
"1923","overminutes",4,7,3,1,0.647475214374182
"1924","overnight",36,45,9,9,1.38744688794467
"1925","overview",12,15,3,1,1.38744688794467
"1926","overwashing",4,7,3,1,0.647475214374182
"1927","overyears",13,19,6,4,0.878716362364961
"1928","oxidetitanium",14,17,3,1,1.5724398063373
"1929","oxychloride",33,42,9,9,1.29495042874836
"1930","pack",4,7,3,1,0.647475214374182
"1931","package",11,14,3,1,1.29495042874836
"1932","packaging",43,55,12,16,1.27182631394928
"1933","pads",17,26,9,9,0.801635979701368
"1934","pain",31,43,12,16,0.99433693636035
"1935","painful",8,14,6,4,0.647475214374182
"1936","palest",11,14,3,1,1.29495042874836
"1937","panoxyl",13,19,6,4,0.878716362364961
"1938","papers",4,7,3,1,0.647475214374182
"1939","papules",9,12,3,1,1.10995751035574
"1940","parenthood",4,7,3,1,0.647475214374182
"1941","parents",9,12,3,1,1.10995751035574
"1942","part",51,69,18,36,1.06370928075758
"1943","partial",9,12,3,1,1.10995751035574
"1944","particilarly",4,7,3,1,0.647475214374182
"1945","particular",12,15,3,1,1.38744688794467
"1946","pass",8,11,3,1,1.01746105115943
"1947","passage",4,7,3,1,0.647475214374182
"1948","past",48,72,24,64,0.832468132766805
"1949","pastas",4,7,3,1,0.647475214374182
"1950","pastmonths",4,7,3,1,0.647475214374182
"1951","pastweeks",15,18,3,1,1.66493626553361
"1952","pastyears",9,12,3,1,1.10995751035574
"1953","patch",14,17,3,1,1.5724398063373
"1954","patches",22,31,9,9,0.955796745028554
"1955","pathetic",4,7,3,1,0.647475214374182
"1956","patience",9,12,3,1,1.10995751035574
"1957","patient",9,12,3,1,1.10995751035574
"1958","paulas",29,38,9,9,1.17162181648661
"1959","pay",17,20,3,1,1.84992918392623
"1960","paying",4,7,3,1,0.647475214374182
"1961","pca",14,17,3,1,1.5724398063373
"1962","pcos",8,14,6,4,0.647475214374182
"1963","peanut",4,7,3,1,0.647475214374182
"1964","peel",34,46,12,16,1.06370928075758
"1965","peeling",33,45,12,16,1.04058516595851
"1966","peels",51,66,15,25,1.22095326139131
"1968","peoples",4,7,3,1,0.647475214374182
"1969","pepsi",9,12,3,1,1.10995751035574
"1970","per",41,56,15,25,1.03596034299869
"1971","percent",9,12,3,1,1.10995751035574
"1972","perfect",71,92,21,49,1.21566774943724
"1973","perfecting",11,14,3,1,1.29495042874836
"1974","perhaps",29,41,12,16,0.948088706762194
"1975","period",76,109,33,121,0.91655582294527
"1976","periods",15,21,6,4,0.971212821561272
"1977","permanent",30,42,12,16,0.971212821561272
"1978","permanently",9,12,3,1,1.10995751035574
"1979","peroxide",180,249,69,529,1.00137471042963
"1980","peroxidethis",4,7,3,1,0.647475214374182
"1981","perricones",9,12,3,1,1.10995751035574
"1982","persistent",21,27,6,4,1.24870219915021
"1983","person",63,84,21,49,1.10995751035574
"1984","personally",82,109,27,81,1.12023489471089
"1985","ph",37,49,12,16,1.13308162515482
"1986","phobia",4,7,3,1,0.647475214374182
"1987","photo",4,7,3,1,0.647475214374182
"1988","physical",12,18,6,4,0.832468132766805
"1989","physicians",11,14,3,1,1.29495042874836
"1990","pick",51,69,18,36,1.06370928075758
"1991","picking",61,88,27,81,0.904409823252825
"1992","pics",23,29,6,4,1.34119865834652
"1993","picture",16,22,6,4,1.01746105115943
"1994","pictures",9,12,3,1,1.10995751035574
"1995","pie",13,19,6,4,0.878716362364961
"1996","piece",9,12,3,1,1.10995751035574
"1997","pigment",11,17,6,4,0.786219903168649
"1998","pigmentation",8,14,6,4,0.647475214374182
"1999","pigmented",7,10,3,1,0.924964591963116
"2000","pih",26,38,12,16,0.878716362364961
"2001","piles",14,17,3,1,1.5724398063373
"2002","pill",64,82,18,36,1.26411827568293
"2003","pillowcases",21,27,6,4,1.24870219915021
"2004","pills",32,44,12,16,1.01746105115943
"2005","pimple",118,163,45,225,1.00512818993325
"2006","pimples",66,99,33,121,0.832468132766805
"2007","pimplesi",11,14,3,1,1.29495042874836
"2008","pink",4,7,3,1,0.647475214374182
"2009","pinnacle",6,9,3,1,0.832468132766805
"2010","pinprick",9,12,3,1,1.10995751035574
"2011","pitted",14,17,3,1,1.5724398063373
"2012","pizza",4,7,3,1,0.647475214374182
"2013","place",13,19,6,4,0.878716362364961
"2014","placeits",15,18,3,1,1.66493626553361
"2015","plague",12,15,3,1,1.38744688794467
"2016","plaguing",17,20,3,1,1.84992918392623
"2017","plainly",11,14,3,1,1.29495042874836
"2018","plan",13,19,6,4,0.878716362364961
"2019","planned",4,7,3,1,0.647475214374182
"2020","plant",30,39,9,9,1.20245396955205
"2021","plantmilks",16,19,3,1,1.75743272472992
"2022","plastic",18,24,6,4,1.10995751035574
"2023","playing",9,12,3,1,1.10995751035574
"2024","plays",9,12,3,1,1.10995751035574
"2025","please",122,164,42,196,1.08352995058536
"2026","plenty",24,33,9,9,1.01746105115943
"2027","plumping",4,7,3,1,0.647475214374182
"2028","plunge",18,24,6,4,1.10995751035574
"2029","plus",68,95,27,81,0.976351513738845
"2030","pm",64,82,18,36,1.26411827568293
"2031","pms",11,14,3,1,1.29495042874836
"2032","point",52,76,24,64,0.878716362364961
"2033","pointing",4,7,3,1,0.647475214374182
"2034","poke",9,12,3,1,1.10995751035574
"2035","ponds",9,12,3,1,1.10995751035574
"2036","poor",26,38,12,16,0.878716362364961
"2037","pop",52,73,21,49,0.964605931618679
"2038","poppick",9,12,3,1,1.10995751035574
"2039","popping",26,38,12,16,0.878716362364961
"2040","pops",13,19,6,4,0.878716362364961
"2041","pore",20,26,6,4,1.20245396955205
"2042","pores",72,108,36,144,0.832468132766805
"2043","portion",4,7,3,1,0.647475214374182
"2044","portraits",9,12,3,1,1.10995751035574
"2045","posay",4,7,3,1,0.647475214374182
"2046","posays",9,12,3,1,1.10995751035574
"2047","positive",15,21,6,4,0.971212821561272
"2048","possible",37,52,15,25,0.961963175641641
"2049","possiblei",4,7,3,1,0.647475214374182
"2050","possibly",23,29,6,4,1.34119865834652
"2051","post",17,26,9,9,0.801635979701368
"2052","posting",4,7,3,1,0.647475214374182
"2053","posts",3,6,3,1,0.55497875517787
"2054","potato",4,7,3,1,0.647475214374182
"2055","potent",19,25,6,4,1.1562057399539
"2056","potential",19,28,9,9,0.863300285832242
"2057","potentially",11,14,3,1,1.29495042874836
"2058","powder",91,118,27,81,1.2127313539072
"2059","power",22,28,6,4,1.29495042874836
"2060","powerful",11,14,3,1,1.29495042874836
"2061","ppl",18,24,6,4,1.10995751035574
"2062","practice",24,30,6,4,1.38744688794467
"2063","pre",9,12,3,1,1.10995751035574
"2064","preach",12,15,3,1,1.38744688794467
"2065","precleanse",4,7,3,1,0.647475214374182
"2066","prednisone",11,14,3,1,1.29495042874836
"2067","prednisoneif",4,7,3,1,0.647475214374182
"2068","prefer",8,14,6,4,0.647475214374182
"2069","pregnancy",4,7,3,1,0.647475214374182
"2070","pregnant",77,101,24,64,1.16776779735343
"2071","prepping",4,7,3,1,0.647475214374182
"2072","prescribe",22,31,9,9,0.955796745028554
"2073","prescribed",52,76,24,64,0.878716362364961
"2074","prescribing",9,12,3,1,1.10995751035574
"2075","prescription",20,35,15,25,0.647475214374182
"2076","prescriptions",9,12,3,1,1.10995751035574
"2077","presence",9,12,3,1,1.10995751035574
"2078","presentable",6,9,3,1,0.832468132766805
"2079","press",18,24,6,4,1.10995751035574
"2080","pressure",4,7,3,1,0.647475214374182
"2081","pretty",176,242,66,484,1.01746105115943
"2082","prettyexpensive",11,14,3,1,1.29495042874836
"2083","prevent",25,31,6,4,1.43369511754283
"2084","prevented",13,19,6,4,0.878716362364961
"2085","prevention",4,7,3,1,0.647475214374182
"2086","preventionsunscreennon",11,14,3,1,1.29495042874836
"2087","prevents",11,14,3,1,1.29495042874836
"2088","previous",17,26,9,9,0.801635979701368
"2089","previously",11,14,3,1,1.29495042874836
"2090","prices",9,12,3,1,1.10995751035574
"2091","pricey",15,21,6,4,0.971212821561272
"2092","primary",18,24,6,4,1.10995751035574
"2093","primer",11,14,3,1,1.29495042874836
"2094","primrose",9,12,3,1,1.10995751035574
"2095","prior",35,44,9,9,1.35661473487924
"2096","pro",26,35,9,9,1.0791253572903
"2097","proactiv",14,17,3,1,1.5724398063373
"2098","proactive",27,39,12,16,0.901840477164038
"2099","proactives",4,7,3,1,0.647475214374182
"2100","probably",131,176,45,225,1.08529178790339
"2101","probablyit",3,6,3,1,0.55497875517787
"2102","probiotic",9,12,3,1,1.10995751035574
"2103","probiotics",81,108,27,81,1.10995751035574
"2104","problem",90,123,33,121,1.03427858919512
"2105","problems",34,52,18,36,0.801635979701368
"2106","process",20,26,6,4,1.20245396955205
"2107","processed",26,32,6,4,1.47994334714099
"2108","produce",8,14,6,4,0.647475214374182
"2109","product",131,185,54,324,0.950658052850981
"2110","production",19,28,9,9,0.863300285832242
"2111","products",326,446,120,1600,1.03133552003887
"2112","professional",13,19,6,4,0.878716362364961
"2113","professionally",4,7,3,1,0.647475214374182
"2114","professionals",4,7,3,1,0.647475214374182
"2115","progress",4,7,3,1,0.647475214374182
"2116","prolonged",4,7,3,1,0.647475214374182
"2117","promise",13,19,6,4,0.878716362364961
"2118","promote",4,7,3,1,0.647475214374182
"2119","promptly",9,12,3,1,1.10995751035574
"2120","prone",80,104,24,64,1.20245396955205
"2121","pronlem",4,7,3,1,0.647475214374182
"2122","proper",9,12,3,1,1.10995751035574
"2123","properly",39,51,12,16,1.17932985475297
"2124","pros",25,31,6,4,1.43369511754283
"2125","protecting",9,12,3,1,1.10995751035574
"2126","protection",9,12,3,1,1.10995751035574
"2127","protectors",11,14,3,1,1.29495042874836
"2128","protein",76,106,30,100,0.980462467480903
"2129","proven",13,19,6,4,0.878716362364961
"2130","provide",13,19,6,4,0.878716362364961
"2131","provided",16,22,6,4,1.01746105115943
"2132","providing",4,7,3,1,0.647475214374182
"2133","psoriasis",24,30,6,4,1.38744688794467
"2134","puberty",12,18,6,4,0.832468132766805
"2135","public",4,7,3,1,0.647475214374182
"2136","pull",5,8,3,1,0.739971673570493
"2137","pulled",9,12,3,1,1.10995751035574
"2138","pulling",9,12,3,1,1.10995751035574
"2139","purchase",9,12,3,1,1.10995751035574
"2140","purge",86,134,48,256,0.77465784576911
"2141","purged",9,12,3,1,1.10995751035574
"2142","purgefor",4,7,3,1,0.647475214374182
"2143","purges",4,7,3,1,0.647475214374182
"2144","purgewhile",11,14,3,1,1.29495042874836
"2145","purging",58,85,27,81,0.873577670187388
"2146","push",39,57,18,36,0.878716362364961
"2147","pushed",4,7,3,1,0.647475214374182
"2148","puss",9,12,3,1,1.10995751035574
"2149","put",102,150,48,256,0.867154304965422
"2150","putting",28,40,12,16,0.924964591963116
"2151","qtip",3,6,3,1,0.55497875517787
"2152","qualities",11,14,3,1,1.29495042874836
"2153","quality",36,48,12,16,1.10995751035574
"2154","queen",4,7,3,1,0.647475214374182
"2155","question",38,56,18,36,0.863300285832242
"2156","questions",13,19,6,4,0.878716362364961
"2157","questionso",4,7,3,1,0.647475214374182
"2158","quick",34,43,9,9,1.3257825818138
"2159","quicker",9,12,3,1,1.10995751035574
"2160","quickly",15,18,3,1,1.66493626553361
"2161","quit",13,19,6,4,0.878716362364961
"2162","quite",26,38,12,16,0.878716362364961
"2163","quitting",21,27,6,4,1.24870219915021
"2164","raccutane",7,13,6,4,0.601226984776026
"2165","ran",4,7,3,1,0.647475214374182
"2166","random",17,26,9,9,0.801635979701368
"2167","range",33,45,12,16,1.04058516595851
"2168","rarely",4,7,3,1,0.647475214374182
"2169","rarer",4,7,3,1,0.647475214374182
"2170","rasianbeauty",4,7,3,1,0.647475214374182
"2171","rate",22,31,9,9,0.955796745028554
"2172","rather",24,36,12,16,0.832468132766805
"2173","razor",4,7,3,1,0.647475214374182
"2174","razors",4,7,3,1,0.647475214374182
"2175","react",9,12,3,1,1.10995751035574
"2176","reaction",9,12,3,1,1.10995751035574
"2177","read",65,95,30,100,0.878716362364961
"2178","reading",4,7,3,1,0.647475214374182
"2179","real",43,61,18,36,0.940380668495835
"2180","reality",8,14,6,4,0.647475214374182
"2181","realize",9,12,3,1,1.10995751035574
"2183","realself",4,7,3,1,0.647475214374182
"2184","rear",4,7,3,1,0.647475214374182
"2185","rearing",4,7,3,1,0.647475214374182
"2186","reason",66,93,27,81,0.955796745028554
"2187","reasons",40,52,12,16,1.20245396955205
"2188","reassess",12,15,3,1,1.38744688794467
"2189","reassurance",4,7,3,1,0.647475214374182
"2190","rebalance",18,24,6,4,1.10995751035574
"2191","recall",11,14,3,1,1.29495042874836
"2192","reccomand",14,17,3,1,1.5724398063373
"2193","reccomendation",4,7,3,1,0.647475214374182
"2194","receive",4,7,3,1,0.647475214374182
"2195","recent",4,7,3,1,0.647475214374182
"2196","recently",84,117,33,121,0.983825975088042
"2197","recommend",246,330,84,784,1.09013684052796
"2198","recommendation",13,19,6,4,0.878716362364961
"2199","recommended",54,69,15,25,1.2764511369091
"2200","recommends",4,7,3,1,0.647475214374182
"2201","recover",15,18,3,1,1.66493626553361
"2202","rectified",11,14,3,1,1.29495042874836
"2203","red",41,65,24,64,0.751533730970032
"2204","reddit",7,13,6,4,0.601226984776026
"2205","redness",29,41,12,16,0.948088706762194
"2206","redo",11,14,3,1,1.29495042874836
"2207","reduce",29,38,9,9,1.17162181648661
"2208","reduces",9,12,3,1,1.10995751035574
"2209","reducing",13,19,6,4,0.878716362364961
"2210","reduction",11,14,3,1,1.29495042874836
"2211","reference",4,7,3,1,0.647475214374182
"2212","refillsalyic",4,7,3,1,0.647475214374182
"2213","refined",18,24,6,4,1.10995751035574
"2214","refreshing",11,14,3,1,1.29495042874836
"2215","refuse",4,7,3,1,0.647475214374182
"2216","regarding",4,7,3,1,0.647475214374182
"2217","regardless",8,14,6,4,0.647475214374182
"2218","regime",28,40,12,16,0.924964591963116
"2219","regimen",49,70,21,49,0.924964591963116
"2220","regret",23,29,6,4,1.34119865834652
"2221","regretted",11,14,3,1,1.29495042874836
"2222","regular",26,35,9,9,1.0791253572903
"2223","regularly",18,24,6,4,1.10995751035574
"2224","rehydrate",4,7,3,1,0.647475214374182
"2225","relapsed",9,12,3,1,1.10995751035574
"2226","relate",15,18,3,1,1.66493626553361
"2227","related",23,29,6,4,1.34119865834652
"2228","relatively",15,21,6,4,0.971212821561272
"2229","relief",31,43,12,16,0.99433693636035
"2230","religiously",12,15,3,1,1.38744688794467
"2231","reluctant",14,17,3,1,1.5724398063373
"2232","remains",18,24,6,4,1.10995751035574
"2233","remark",11,14,3,1,1.29495042874836
"2234","remember",107,143,36,144,1.10224947208938
"2235","remembering",4,7,3,1,0.647475214374182
"2236","remind",8,14,6,4,0.647475214374182
"2237","remodel",11,14,3,1,1.29495042874836
"2238","removal",4,7,3,1,0.647475214374182
"2239","remove",15,21,6,4,0.971212821561272
"2240","removed",52,73,21,49,0.964605931618679
"2241","remover",4,7,3,1,0.647475214374182
"2242","removing",11,14,3,1,1.29495042874836
"2243","renewal",18,24,6,4,1.10995751035574
"2244","repaired",9,12,3,1,1.10995751035574
"2245","repeat",12,18,6,4,0.832468132766805
"2246","replace",4,7,3,1,0.647475214374182
"2247","reported",9,12,3,1,1.10995751035574
"2248","reputable",14,17,3,1,1.5724398063373
"2249","reputation",4,7,3,1,0.647475214374182
"2250","require",14,17,3,1,1.5724398063373
"2251","required",4,7,3,1,0.647475214374182
"2252","rescue",11,14,3,1,1.29495042874836
"2253","research",62,80,18,36,1.23328612261749
"2254","residual",14,17,3,1,1.5724398063373
"2255","resist",11,14,3,1,1.29495042874836
"2256","resistance",9,12,3,1,1.10995751035574
"2257","resistant",4,7,3,1,0.647475214374182
"2258","resolved",9,12,3,1,1.10995751035574
"2259","resolvemonths",4,7,3,1,0.647475214374182
"2260","resort",33,45,12,16,1.04058516595851
"2261","resortand",13,16,3,1,1.47994334714099
"2262","resourceful",4,7,3,1,0.647475214374182
"2263","rest",26,35,9,9,1.0791253572903
"2264","restricting",9,12,3,1,1.10995751035574
"2265","result",21,30,9,9,0.924964591963116
"2266","resulting",4,7,3,1,0.647475214374182
"2267","results",123,165,42,196,1.09013684052796
"2268","resultsits",12,15,3,1,1.38744688794467
"2269","retin",4,7,3,1,0.647475214374182
"2270","retina",28,40,12,16,0.924964591963116
"2271","retinoid",4,7,3,1,0.647475214374182
"2272","retinoids",30,36,6,4,1.66493626553361
"2273","retinol",42,57,15,25,1.05445963483795
"2274","retinolor",14,17,3,1,1.5724398063373
"2275","retinols",18,24,6,4,1.10995751035574
"2276","return",4,7,3,1,0.647475214374182
"2277","returned",20,26,6,4,1.20245396955205
"2278","reviews",13,19,6,4,0.878716362364961
"2279","rewards",4,7,3,1,0.647475214374182
"2280","rewetting",4,7,3,1,0.647475214374182
"2281","rhyme",9,12,3,1,1.10995751035574
"2282","rice",4,7,3,1,0.647475214374182
"2283","rich",18,24,6,4,1.10995751035574
"2284","rid",82,115,33,121,0.967008437052349
"2285","riddled",21,27,6,4,1.24870219915021
"2286","ridges",14,17,3,1,1.5724398063373
"2287","ridiculous",9,12,3,1,1.10995751035574
"2288","ridiculously",15,18,3,1,1.66493626553361
"2289","right",136,193,57,361,0.939569296046745
"2290","righthopefully",9,12,3,1,1.10995751035574
"2291","rimmel",11,14,3,1,1.29495042874836
"2292","ripping",11,14,3,1,1.29495042874836
"2293","risk",39,48,9,9,1.47994334714099
"2294","risks",17,23,6,4,1.06370928075758
"2295","roche",17,26,9,9,0.801635979701368
"2296","role",9,12,3,1,1.10995751035574
"2297","roll",9,12,3,1,1.10995751035574
"2298","roller",38,47,9,9,1.44911119407555
"2299","rollerdays",12,15,3,1,1.38744688794467
"2300","rolling",4,7,3,1,0.647475214374182
"2301","rose",11,14,3,1,1.29495042874836
"2302","rosebud",9,12,3,1,1.10995751035574
"2303","rosehip",9,12,3,1,1.10995751035574
"2304","rosehipjojoba",11,14,3,1,1.29495042874836
"2305","rough",14,17,3,1,1.5724398063373
"2306","round",34,49,15,25,0.906465300123854
"2307","route",18,24,6,4,1.10995751035574
"2308","routine",160,229,69,529,0.920943006780668
"2309","routineand",9,12,3,1,1.10995751035574
"2310","row",4,7,3,1,0.647475214374182
"2311","rskincareaddicton",14,17,3,1,1.5724398063373
"2312","rub",17,26,9,9,0.801635979701368
"2313","rude",11,14,3,1,1.29495042874836
"2314","ruined",4,7,3,1,0.647475214374182
"2315","run",4,7,3,1,0.647475214374182
"2316","runs",15,18,3,1,1.66493626553361
"2317","s",10,16,6,4,0.739971673570493
"2318","sa",3,6,3,1,0.55497875517787
"2319","sad",4,7,3,1,0.647475214374182
"2320","sadly",9,12,3,1,1.10995751035574
"2321","safe",47,62,15,25,1.14695609403426
"2322","safer",11,14,3,1,1.29495042874836
"2323","safety",4,7,3,1,0.647475214374182
"2324","saggy",8,11,3,1,1.01746105115943
"2325","said",173,248,75,625,0.917564875227411
"2326","sales",5,8,3,1,0.739971673570493
"2327","salicylic",107,140,33,121,1.17722766249851
"2328","salve",9,12,3,1,1.10995751035574
"2329","save",13,19,6,4,0.878716362364961
"2330","saved",8,14,6,4,0.647475214374182
"2331","saver",14,17,3,1,1.5724398063373
"2332","saviour",9,12,3,1,1.10995751035574
"2333","saw",4,7,3,1,0.647475214374182
"2334","say",168,228,60,400,1.05445963483795
"2335","saying",18,24,6,4,1.10995751035574
"2336","saymuch",9,12,3,1,1.10995751035574
"2337","says",23,32,9,9,0.986628898093991
"2338","saysderms",9,12,3,1,1.10995751035574
"2339","scab",9,12,3,1,1.10995751035574
"2340","scabbed",4,7,3,1,0.647475214374182
"2341","scabs",9,12,3,1,1.10995751035574
"2342","scale",16,22,6,4,1.01746105115943
"2343","scalp",25,31,6,4,1.43369511754283
"2344","scar",31,43,12,16,0.99433693636035
"2345","scares",4,7,3,1,0.647475214374182
"2346","scarring",153,201,48,256,1.16198676865366
"2347","scars",194,275,81,729,0.942093565888359
"2348","scarsyou",11,14,3,1,1.29495042874836
"2349","scary",30,42,12,16,0.971212821561272
"2350","schedule",11,14,3,1,1.29495042874836
"2351","school",57,87,30,100,0.804719195007911
"2352","scoby",24,30,6,4,1.38744688794467
"2353","screw",11,14,3,1,1.29495042874836
"2354","scrub",18,24,6,4,1.10995751035574
"2355","scrubber",14,17,3,1,1.5724398063373
"2356","scrubbing",11,14,3,1,1.29495042874836
"2357","scrubs",11,14,3,1,1.29495042874836
"2358","scrubtimes",4,7,3,1,0.647475214374182
"2359","seabreeze",4,7,3,1,0.647475214374182
"2360","seal",13,19,6,4,0.878716362364961
"2361","search",4,7,3,1,0.647475214374182
"2362","searching",11,14,3,1,1.29495042874836
"2363","sebum",19,28,9,9,0.863300285832242
"2364","second",30,42,12,16,0.971212821561272
"2365","seconds",11,14,3,1,1.29495042874836
"2366","see",323,449,126,1764,0.988831194741522
"2367","seeing",17,26,9,9,0.801635979701368
"2368","seeking",11,14,3,1,1.29495042874836
"2369","seem",56,71,15,25,1.31344972058763
"2370","seems",161,218,57,361,1.06127516341031
"2371","seen",62,80,18,36,1.23328612261749
"2372","selection",11,14,3,1,1.29495042874836
"2373","self",26,35,9,9,1.0791253572903
"2374","selfconscious",9,12,3,1,1.10995751035574
"2375","selfesteem",4,7,3,1,0.647475214374182
"2376","selftreating",9,12,3,1,1.10995751035574
"2377","sell",9,12,3,1,1.10995751035574
"2378","sensation",41,56,15,25,1.03596034299869
"2379","sense",19,28,9,9,0.863300285832242
"2380","sensitive",131,179,48,256,1.03480413725874
"2381","sensitiveallergic",9,12,3,1,1.10995751035574
"2382","sensitivity",4,7,3,1,0.647475214374182
"2383","sephora",14,17,3,1,1.5724398063373
"2384","september",4,7,3,1,0.647475214374182
"2385","series",18,24,6,4,1.10995751035574
"2386","serious",20,26,6,4,1.20245396955205
"2387","seriously",48,69,21,49,0.911750812077929
"2388","serum",69,90,21,49,1.18924018966686
"2389","serums",14,17,3,1,1.5724398063373
"2390","service",4,7,3,1,0.647475214374182
"2391","set",29,38,9,9,1.17162181648661
"2392","setting",33,42,9,9,1.29495042874836
"2393","settle",3,6,3,1,0.55497875517787
"2394","several",54,78,24,64,0.901840477164038
"2395","severe",69,93,24,64,1.07527133815712
"2396","severeness",4,7,3,1,0.647475214374182
"2397","shades",11,14,3,1,1.29495042874836
"2398","shady",11,14,3,1,1.29495042874836
"2399","shallow",4,7,3,1,0.647475214374182
"2400","shambles",9,12,3,1,1.10995751035574
"2401","shampoo",73,94,21,49,1.24209530920761
"2402","shape",4,7,3,1,0.647475214374182
"2403","share",4,7,3,1,0.647475214374182
"2404","shattered",11,14,3,1,1.29495042874836
"2405","shave",7,10,3,1,0.924964591963116
"2406","shaver",4,7,3,1,0.647475214374182
"2407","shaving",40,55,15,25,1.01746105115943
"2408","shed",4,7,3,1,0.647475214374182
"2409","sheet",9,12,3,1,1.10995751035574
"2410","sheets",38,50,12,16,1.1562057399539
"2411","shes",34,52,18,36,0.801635979701368
"2412","shetold",4,7,3,1,0.647475214374182
"2413","shine",11,14,3,1,1.29495042874836
"2414","shiny",11,14,3,1,1.29495042874836
"2415","shirt",39,51,12,16,1.17932985475297
"2416","shit",73,103,30,100,0.95271352972201
"2417","shitty",21,27,6,4,1.24870219915021
"2418","shoddy",9,12,3,1,1.10995751035574
"2419","shop",4,7,3,1,0.647475214374182
"2420","short",47,59,12,16,1.3643227731456
"2421","shorter",9,12,3,1,1.10995751035574
"2422","shot",79,106,27,81,1.08940274164545
"2423","shouldersback",4,7,3,1,0.647475214374182
"2424","shouldnt",8,14,6,4,0.647475214374182
"2425","show",40,52,12,16,1.20245396955205
"2426","shower",71,98,27,81,1.00718366680428
"2427","showering",9,12,3,1,1.10995751035574
"2428","showers",4,7,3,1,0.647475214374182
"2429","showerworking",9,12,3,1,1.10995751035574
"2430","showing",15,18,3,1,1.66493626553361
"2431","shown",12,15,3,1,1.38744688794467
"2432","shy",9,12,3,1,1.10995751035574
"2433","sick",26,32,6,4,1.47994334714099
"2434","side",127,187,60,400,0.864841893485514
"2435","sidebar",9,12,3,1,1.10995751035574
"2436","sides",19,28,9,9,0.863300285832242
"2437","sigh",11,14,3,1,1.29495042874836
"2438","significant",11,14,3,1,1.29495042874836
"2439","significantly",40,55,15,25,1.01746105115943
"2440","silicone",9,12,3,1,1.10995751035574
"2441","similar",79,112,33,121,0.941782129998809
"2442","simple",84,120,36,144,0.924964591963116
"2443","simply",17,26,9,9,0.801635979701368
"2445","single",24,33,9,9,1.01746105115943
"2446","sis",9,12,3,1,1.10995751035574
"2447","sister",14,20,6,4,0.924964591963116
"2448","site",9,12,3,1,1.10995751035574
"2449","situation",20,32,12,16,0.739971673570493
"2450","situations",4,7,3,1,0.647475214374182
"2451","six",27,36,9,9,1.10995751035574
"2452","size",18,24,6,4,1.10995751035574
"2453","sizes",4,7,3,1,0.647475214374182
"2454","skim",15,18,3,1,1.66493626553361
"2456","skincare",105,138,33,121,1.16041012446282
"2457","skinduring",9,12,3,1,1.10995751035574
"2458","skinny",9,12,3,1,1.10995751035574
"2459","skins",13,19,6,4,0.878716362364961
"2460","skinthe",4,7,3,1,0.647475214374182
"2461","skip",13,19,6,4,0.878716362364961
"2462","skipping",4,7,3,1,0.647475214374182
"2463","slather",28,37,9,9,1.14078966342118
"2464","sleep",51,75,24,64,0.867154304965422
"2465","sleeping",8,14,6,4,0.647475214374182
"2466","sleepwear",14,17,3,1,1.5724398063373
"2467","slide",9,12,3,1,1.10995751035574
"2468","slides",9,12,3,1,1.10995751035574
"2469","sliding",4,7,3,1,0.647475214374182
"2470","slightly",8,14,6,4,0.647475214374182
"2471","slowly",16,28,12,16,0.647475214374182
"2472","sls",4,7,3,1,0.647475214374182
"2473","slsirritants",9,12,3,1,1.10995751035574
"2474","small",43,61,18,36,0.940380668495835
"2475","smaller",20,29,9,9,0.894132438897679
"2476","smell",32,47,15,25,0.869466716445329
"2477","smile",13,19,6,4,0.878716362364961
"2478","smiling",9,12,3,1,1.10995751035574
"2479","smiths",9,12,3,1,1.10995751035574
"2480","smoke",9,12,3,1,1.10995751035574
"2481","smooth",10,13,3,1,1.20245396955205
"2482","smoother",4,7,3,1,0.647475214374182
"2483","soak",4,7,3,1,0.647475214374182
"2484","soap",80,98,18,36,1.51077550020642
"2485","social",4,7,3,1,0.647475214374182
"2486","soda",4,7,3,1,0.647475214374182
"2487","soft",24,33,9,9,1.01746105115943
"2488","softsoap",9,12,3,1,1.10995751035574
"2489","solution",40,55,15,25,1.01746105115943
"2490","solutions",29,35,6,4,1.61868803593545
"2491","solved",4,7,3,1,0.647475214374182
"2492","someday",4,7,3,1,0.647475214374182
"2493","somehow",15,18,3,1,1.66493626553361
"2495","somerville",14,17,3,1,1.5724398063373
"2496","something",136,193,57,361,0.939569296046745
"2497","sometime",4,7,3,1,0.647475214374182
"2498","sometimes",133,184,51,289,1.00113814659537
"2499","somewhere",9,12,3,1,1.10995751035574
"2500","soon",86,119,33,121,1.00064351312374
"2501","sooner",29,41,12,16,0.948088706762194
"2502","sooo",9,12,3,1,1.10995751035574
"2503","sooooooo",18,24,6,4,1.10995751035574
"2504","soothed",4,7,3,1,0.647475214374182
"2505","soothes",4,7,3,1,0.647475214374182
"2506","sophomore",4,7,3,1,0.647475214374182
"2507","sore",9,12,3,1,1.10995751035574
"2508","sorry",58,82,24,64,0.948088706762194
"2509","sort",17,26,9,9,0.801635979701368
"2510","sorted",23,29,6,4,1.34119865834652
"2511","sorts",4,7,3,1,0.647475214374182
"2512","sound",8,14,6,4,0.647475214374182
"2513","sounds",46,64,18,36,0.986628898093991
"2514","source",18,26,8,9,0.901840477164038
"2515","south",11,14,3,1,1.29495042874836
"2516","soy",21,33,12,16,0.763095788369571
"2517","soyalmond",11,14,3,1,1.29495042874836
"2518","spaghetti",4,7,3,1,0.647475214374182
"2519","speaking",4,7,3,1,0.647475214374182
"2520","spearmint",13,19,6,4,0.878716362364961
"2521","specialist",4,7,3,1,0.647475214374182
"2522","specific",25,40,15,25,0.739971673570493
"2523","specifically",19,25,6,4,1.1562057399539
"2524","speed",4,7,3,1,0.647475214374182
"2525","spend",9,12,3,1,1.10995751035574
"2526","spent",28,34,6,4,1.5724398063373
"2527","spf",37,46,9,9,1.41827904101011
"2528","spfin",29,38,9,9,1.17162181648661
"2529","spfsunscreen",17,20,3,1,1.84992918392623
"2530","spirnolactone",4,7,3,1,0.647475214374182
"2531","spiro",25,40,15,25,0.739971673570493
"2532","spirolactone",4,7,3,1,0.647475214374182
"2533","spironlactone",11,14,3,1,1.29495042874836
"2534","spironolactone",34,52,18,36,0.801635979701368
"2535","spoke",4,7,3,1,0.647475214374182
"2536","sponge",11,14,3,1,1.29495042874836
"2537","spot",61,91,30,100,0.841717778686436
"2538","spots",68,98,30,100,0.906465300123854
"2539","spread",4,7,3,1,0.647475214374182
"2540","spreading",14,17,3,1,1.5724398063373
"2541","spreads",14,17,3,1,1.5724398063373
"2542","spring",4,7,3,1,0.647475214374182
"2543","sprintec",4,7,3,1,0.647475214374182
"2544","spur",4,7,3,1,0.647475214374182
"2545","squat",4,7,3,1,0.647475214374182
"2546","squeaky",11,14,3,1,1.29495042874836
"2547","squeeze",9,12,3,1,1.10995751035574
"2548","sre",4,7,3,1,0.647475214374182
"2549","srry",15,18,3,1,1.66493626553361
"2550","st",14,17,3,1,1.5724398063373
"2551","stabilize",9,12,3,1,1.10995751035574
"2552","staph",11,17,6,4,0.786219903168649
"2553","stars",4,7,3,1,0.647475214374182
"2554","start",180,258,78,676,0.917849479717246
"2555","started",252,354,102,1156,0.963051369279245
"2556","starter",15,18,3,1,1.66493626553361
"2557","starting",39,57,18,36,0.878716362364961
"2558","starts",4,7,3,1,0.647475214374182
"2559","state",9,12,3,1,1.10995751035574
"2560","states",9,12,3,1,1.10995751035574
"2561","status",11,14,3,1,1.29495042874836
"2562","stay",60,75,15,25,1.38744688794467
"2563","stayed",12,15,3,1,1.38744688794467
"2564","staying",11,14,3,1,1.29495042874836
"2565","steadily",4,7,3,1,0.647475214374182
"2566","steady",4,7,3,1,0.647475214374182
"2567","steam",9,12,3,1,1.10995751035574
"2568","steps",14,17,3,1,1.5724398063373
"2569","sterile",4,7,3,1,0.647475214374182
"2570","sterilized",9,12,3,1,1.10995751035574
"2571","steroid",4,7,3,1,0.647475214374182
"2572","stick",15,27,12,16,0.624351099575104
"2573","sticking",11,14,3,1,1.29495042874836
"2574","sticks",13,16,3,1,1.47994334714099
"2575","stiffness",4,7,3,1,0.647475214374182
"2576","still",362,494,132,1936,1.03848297370404
"2577","stillyears",9,12,3,1,1.10995751035574
"2578","stock",26,32,6,4,1.47994334714099
"2579","stomach",9,12,3,1,1.10995751035574
"2580","stop",81,114,33,121,0.958599668034502
"2581","stopped",113,164,51,289,0.892318782835006
"2582","stopping",9,12,3,1,1.10995751035574
"2583","store",69,87,18,36,1.34119865834652
"2584","stories",6,9,3,1,0.832468132766805
"2585","story",4,7,3,1,0.647475214374182
"2586","straight",13,19,6,4,0.878716362364961
"2587","straightforward",3,6,3,1,0.55497875517787
"2588","strange",4,7,3,1,0.647475214374182
"2589","street",14,17,3,1,1.5724398063373
"2590","strength",8,14,6,4,0.647475214374182
"2591","stress",52,73,21,49,0.964605931618679
"2592","stressed",4,7,3,1,0.647475214374182
"2593","stressing",9,12,3,1,1.10995751035574
"2594","strh",11,17,6,4,0.786219903168649
"2595","strict",14,17,3,1,1.5724398063373
"2596","strictest",9,12,3,1,1.10995751035574
"2597","stridex",20,29,9,9,0.894132438897679
"2598","strips",4,7,3,1,0.647475214374182
"2599","strong",12,21,9,9,0.647475214374182
"2600","strongermore",4,7,3,1,0.647475214374182
"2601","struggle",4,7,3,1,0.647475214374182
"2602","struggling",4,7,3,1,0.647475214374182
"2603","stubborn",24,30,6,4,1.38744688794467
"2604","stuck",13,19,6,4,0.878716362364961
"2605","studies",11,14,3,1,1.29495042874836
"2606","study",21,27,6,4,1.24870219915021
"2607","stuff",98,137,39,169,0.974770377684207
"2608","stuffit",9,12,3,1,1.10995751035574
"2609","stung",15,18,3,1,1.66493626553361
"2610","stupid",11,14,3,1,1.29495042874836
"2611","style",9,12,3,1,1.10995751035574
"2612","styling",11,14,3,1,1.29495042874836
"2613","sub",29,44,15,25,0.813968840927542
"2614","subreddit",8,14,6,4,0.647475214374182
"2615","subsided",9,12,3,1,1.10995751035574
"2616","subsides",4,7,3,1,0.647475214374182
"2617","success",37,55,18,36,0.847884209299523
"2618","suck",4,7,3,1,0.647475214374182
"2619","sucked",9,12,3,1,1.10995751035574
"2620","sucks",64,91,27,81,0.935241976318262
"2621","sudden",9,12,3,1,1.10995751035574
"2622","sue",9,12,3,1,1.10995751035574
"2623","sued",9,12,3,1,1.10995751035574
"2624","suffer",4,7,3,1,0.647475214374182
"2625","sufferer",4,7,3,1,0.647475214374182
"2626","sufferers",12,15,3,1,1.38744688794467
"2627","sugar",146,206,60,400,0.95271352972201
"2628","sugars",22,31,9,9,0.955796745028554
"2629","sugary",4,7,3,1,0.647475214374182
"2630","suggest",39,54,15,25,0.998961759320166
"2631","suggested",39,48,9,9,1.47994334714099
"2632","suggestion",4,7,3,1,0.647475214374182
"2633","suggestions",32,41,9,9,1.26411827568293
"2634","suggests",13,19,6,4,0.878716362364961
"2635","suicidal",44,59,15,25,1.09145821851648
"2636","suicide",9,12,3,1,1.10995751035574
"2637","suitable",9,12,3,1,1.10995751035574
"2638","sulfur",4,7,3,1,0.647475214374182
"2639","summer",21,33,12,16,0.763095788369571
"2640","sun",75,96,21,49,1.26852286897799
"2641","sunblock",4,7,3,1,0.647475214374182
"2642","sunlight",8,14,6,4,0.647475214374182
"2643","sunny",4,7,3,1,0.647475214374182
"2644","sunscreen",234,306,72,576,1.17932985475297
"2645","sunscreens",14,17,3,1,1.5724398063373
"2646","super",75,102,27,81,1.04829320422487
"2647","supervisor",9,12,3,1,1.10995751035574
"2648","suppl",4,7,3,1,0.647475214374182
"2649","supple",11,14,3,1,1.29495042874836
"2650","supplement",46,64,18,36,0.986628898093991
"2651","supplements",32,53,21,49,0.700330333914931
"2652","supplents",9,12,3,1,1.10995751035574
"2653","support",8,14,6,4,0.647475214374182
"2654","suppose",17,26,9,9,0.801635979701368
"2655","supposed",22,31,9,9,0.955796745028554
"2657","surely",4,7,3,1,0.647475214374182
"2658","surface",73,100,27,81,1.02773843551457
"2659","surge",22,28,6,4,1.29495042874836
"2660","surgeons",14,17,3,1,1.5724398063373
"2661","surprise",4,7,3,1,0.647475214374182
"2662","suspect",4,7,3,1,0.647475214374182
"2663","suspected",11,14,3,1,1.29495042874836
"2664","sustainable",11,14,3,1,1.29495042874836
"2665","swap",9,12,3,1,1.10995751035574
"2666","swear",11,14,3,1,1.29495042874836
"2667","sweat",53,68,15,25,1.25795184506984
"2668","sweaty",14,17,3,1,1.5724398063373
"2669","sweet",4,7,3,1,0.647475214374182
"2670","swelling",22,34,12,16,0.786219903168649
"2671","swimming",17,20,3,1,1.84992918392623
"2672","swings",9,12,3,1,1.10995751035574
"2673","switch",14,17,3,1,1.5724398063373
"2674","switched",55,76,21,49,1.00424727127424
"2675","switching",8,14,6,4,0.647475214374182
"2676","swore",9,12,3,1,1.10995751035574
"2677","symptoms",9,12,3,1,1.10995751035574
"2678","synthetic",11,14,3,1,1.29495042874836
"2679","system",46,55,9,9,1.69576841859905
"2680","t",17,23,6,4,1.06370928075758
"2681","tackle",13,19,6,4,0.878716362364961
"2682","taffys",11,14,3,1,1.29495042874836
"2683","take",275,389,114,1444,0.946871648088559
"2684","taken",40,55,15,25,1.01746105115943
"2685","takes",30,42,12,16,0.971212821561272
"2686","taking",222,312,90,900,0.961963175641641
"2687","talk",51,69,18,36,1.06370928075758
"2688","talking",86,110,24,64,1.27182631394928
"2689","tall",18,21,3,1,1.94242564312254
"2690","tan",28,34,6,4,1.5724398063373
"2691","tangible",4,7,3,1,0.647475214374182
"2692","tank",4,7,3,1,0.647475214374182
"2693","tanning",14,17,3,1,1.5724398063373
"2694","taper",4,7,3,1,0.647475214374182
"2695","targeted",9,12,3,1,1.10995751035574
"2696","taught",14,17,3,1,1.5724398063373
"2697","tazorac",8,14,6,4,0.647475214374182
"2698","tazorotene",4,7,3,1,0.647475214374182
"2699","tbh",17,26,9,9,0.801635979701368
"2700","tca",11,14,3,1,1.29495042874836
"2701","tea",113,158,45,225,0.974296036867816
"2702","teatimes",9,12,3,1,1.10995751035574
"2703","teatreewitchhazel",4,7,3,1,0.647475214374182
"2704","technically",4,7,3,1,0.647475214374182
"2705","teddy",4,7,3,1,0.647475214374182
"2706","tee",18,24,6,4,1.10995751035574
"2707","teen",9,12,3,1,1.10995751035574
"2708","teenage",13,19,6,4,0.878716362364961
"2709","teens",24,36,12,16,0.832468132766805
"2710","teenthen",4,7,3,1,0.647475214374182
"2711","teeth",9,12,3,1,1.10995751035574
"2712","tell",68,95,27,81,0.976351513738845
"2713","telling",9,12,3,1,1.10995751035574
"2714","temporary",11,14,3,1,1.29495042874836
"2715","tempting",4,7,3,1,0.647475214374182
"2716","tend",15,21,6,4,0.971212821561272
"2717","term",42,54,12,16,1.24870219915021
"2718","terms",4,7,3,1,0.647475214374182
"2719","terrible",44,62,18,36,0.955796745028554
"2720","terriblethen",18,24,6,4,1.10995751035574
"2721","terribly",15,18,3,1,1.66493626553361
"2722","test",26,38,12,16,0.878716362364961
"2723","tested",9,12,3,1,1.10995751035574
"2724","testosterone",11,14,3,1,1.29495042874836
"2725","tests",12,15,3,1,1.38744688794467
"2726","tetracycline",22,31,9,9,0.955796745028554
"2727","texture",14,17,3,1,1.5724398063373
"2728","th",4,7,3,1,0.647475214374182
"2729","thank",39,51,12,16,1.17932985475297
"2730","thanks",69,96,27,81,0.986628898093991
"2731","thanmonths",4,7,3,1,0.647475214374182
"2732","thanon",12,15,3,1,1.38744688794467
"2733","thatd",4,7,3,1,0.647475214374182
"2734","thatkicked",9,12,3,1,1.10995751035574
"2736","thatworks",3,6,3,1,0.55497875517787
"2737","thc",9,12,3,1,1.10995751035574
"2738","thedaily",4,7,3,1,0.647475214374182
"2739","themit",9,12,3,1,1.10995751035574
"2740","theory",11,14,3,1,1.29495042874836
"2741","therapy",8,14,6,4,0.647475214374182
"2742","therefore",29,38,9,9,1.17162181648661
"2743","theres",34,49,15,25,0.906465300123854
"2744","theseit",11,14,3,1,1.29495042874836
"2745","thestep",9,12,3,1,1.10995751035574
"2746","thethings",4,7,3,1,0.647475214374182
"2747","theweek",4,7,3,1,0.647475214374182
"2748","theyre",69,90,21,49,1.18924018966686
"2749","theyve",19,28,9,9,0.863300285832242
"2750","thicker",18,24,6,4,1.10995751035574
"2751","thin",36,48,12,16,1.10995751035574
"2752","thing",278,380,102,1156,1.03378395572348
"2753","thingi",11,14,3,1,1.29495042874836
"2755","thingscut",4,7,3,1,0.647475214374182
"2757","thinking",4,7,3,1,0.647475214374182
"2758","thinner",9,12,3,1,1.10995751035574
"2759","thinning",4,7,3,1,0.647475214374182
"2760","third",13,19,6,4,0.878716362364961
"2761","thisyou",26,32,6,4,1.47994334714099
"2762","tho",37,58,21,49,0.766399233340868
"2763","thorough",11,14,3,1,1.29495042874836
"2764","thoroughly",11,14,3,1,1.29495042874836
"2765","thosetheyll",12,15,3,1,1.38744688794467
"2767","thoughjust",4,7,3,1,0.647475214374182
"2768","thought",21,33,12,16,0.763095788369571
"2769","thousand",9,12,3,1,1.10995751035574
"2770","thousands",13,19,6,4,0.878716362364961
"2771","threatening",1,4,3,1,0.369985836785247
"2772","three",56,83,27,81,0.853022901477096
"2773","throughi",14,17,3,1,1.5724398063373
"2774","throughout",21,27,6,4,1.24870219915021
"2775","tht",18,24,6,4,1.10995751035574
"2776","thus",15,18,3,1,1.66493626553361
"2777","tight",4,7,3,1,0.647475214374182
"2778","til",9,12,3,1,1.10995751035574
"2779","till",4,7,3,1,0.647475214374182
"2780","time",324,453,129,1849,0.974439442230911
"2781","times",67,100,33,121,0.840876901784651
"2782","tinea",7,10,3,1,0.924964591963116
"2783","tinnitus",11,14,3,1,1.29495042874836
"2784","tiny",4,7,3,1,0.647475214374182
"2785","tip",4,7,3,1,0.647475214374182
"2786","tips",26,38,12,16,0.878716362364961
"2787","tiring",4,7,3,1,0.647475214374182
"2788","titanium",22,28,6,4,1.29495042874836
"2789","today",11,20,9,9,0.616643061308744
"2790","together",21,33,12,16,0.763095788369571
"2791","tohours",14,17,3,1,1.5724398063373
"2792","told",68,86,18,36,1.3257825818138
"2793","tolerance",4,7,3,1,0.647475214374182
"2794","toll",14,17,3,1,1.5724398063373
"2795","tomonths",4,7,3,1,0.647475214374182
"2796","tomorrow",23,29,6,4,1.34119865834652
"2797","tomorrrow",4,7,3,1,0.647475214374182
"2798","ton",20,29,9,9,0.894132438897679
"2799","tone",18,24,6,4,1.10995751035574
"2800","toner",63,90,27,81,0.924964591963116
"2801","toners",9,12,3,1,1.10995751035574
"2802","tones",22,28,6,4,1.29495042874836
"2803","tongue",9,12,3,1,1.10995751035574
"2804","toning",13,19,6,4,0.878716362364961
"2805","tons",26,35,9,9,1.0791253572903
"2806","took",111,159,48,256,0.919183563263347
"2807","tookmonths",16,22,6,4,1.01746105115943
"2808","tookmy",4,7,3,1,0.647475214374182
"2809","tookweeks",4,7,3,1,0.647475214374182
"2810","toothpaste",8,14,6,4,0.647475214374182
"2811","toothpastes",4,7,3,1,0.647475214374182
"2812","tooweeks",4,7,3,1,0.647475214374182
"2813","tooyears",4,7,3,1,0.647475214374182
"2814","top",26,35,9,9,1.0791253572903
"2815","topical",82,106,24,64,1.22557808435113
"2816","topicals",46,64,18,36,0.986628898093991
"2817","tops",4,7,3,1,0.647475214374182
"2818","torn",9,12,3,1,1.10995751035574
"2819","total",4,7,3,1,0.647475214374182
"2820","totally",77,104,27,81,1.06884797293516
"2821","touch",35,50,15,25,0.924964591963116
"2822","touches",18,24,6,4,1.10995751035574
"2823","touching",26,32,6,4,1.47994334714099
"2824","tough",28,40,12,16,0.924964591963116
"2825","toughen",4,7,3,1,0.647475214374182
"2826","tougher",14,17,3,1,1.5724398063373
"2827","towards",13,19,6,4,0.878716362364961
"2828","towel",27,36,9,9,1.10995751035574
"2829","trace",9,12,3,1,1.10995751035574
"2830","trade",9,12,3,1,1.10995751035574
"2831","transformation",4,7,3,1,0.647475214374182
"2832","transparent",11,14,3,1,1.29495042874836
"2833","treat",50,71,21,49,0.938178371848304
"2834","treated",21,33,12,16,0.763095788369571
"2835","treatment",144,198,54,324,1.01746105115943
"2836","treatments",48,66,18,36,1.01746105115943
"2837","treatmentsyronolactone",4,7,3,1,0.647475214374182
"2838","tree",108,150,42,196,0.991033491389053
"2839","tremendously",4,7,3,1,0.647475214374182
"2840","tret",4,7,3,1,0.647475214374182
"2841","tretinoin",61,82,21,49,1.08352995058536
"2842","tretinoinand",9,12,3,1,1.10995751035574
"2843","tri",4,7,3,1,0.647475214374182
"2844","trial",4,7,3,1,0.647475214374182
"2845","trials",4,7,3,1,0.647475214374182
"2846","trick",13,19,6,4,0.878716362364961
"2847","tricyclin",4,7,3,1,0.647475214374182
"2848","tried",284,386,102,1156,1.05010686028754
"2849","trifle",13,16,3,1,1.47994334714099
"2850","trigger",44,65,21,49,0.85889569253718
"2851","triggered",4,7,3,1,0.647475214374182
"2852","triggers",9,12,3,1,1.10995751035574
"2853","triglycerides",8,14,6,4,0.647475214374182
"2854","trisprintec",9,12,3,1,1.10995751035574
"2855","true",8,14,6,4,0.647475214374182
"2856","truly",16,22,6,4,1.01746105115943
"2858","trying",130,181,51,289,0.984815242031318
"2859","tshirts",4,7,3,1,0.647475214374182
"2860","tumerichoneyapple",4,7,3,1,0.647475214374182
"2861","turn",68,86,18,36,1.3257825818138
"2862","turnand",17,20,3,1,1.84992918392623
"2863","turned",17,26,9,9,0.801635979701368
"2864","turnover",12,21,9,9,0.647475214374182
"2865","twat",4,7,3,1,0.647475214374182
"2866","twice",66,90,24,64,1.04058516595851
"2867","two",162,231,69,529,0.928986177145565
"2868","twogetone",11,14,3,1,1.29495042874836
"2869","twothree",4,7,3,1,0.647475214374182
"2870","type",30,45,15,25,0.832468132766805
"2871","types",11,14,3,1,1.29495042874836
"2872","typically",23,29,6,4,1.34119865834652
"2873","u",67,91,24,64,1.05214722335804
"2874","ugh",15,21,6,4,0.971212821561272
"2875","uglier",4,7,3,1,0.647475214374182
"2876","ugliness",4,7,3,1,0.647475214374182
"2877","ugly",16,22,6,4,1.01746105115943
"2878","ultra",11,14,3,1,1.29495042874836
"2879","unclogs",4,7,3,1,0.647475214374182
"2880","uncomfortable",11,14,3,1,1.29495042874836
"2881","undeniable",16,22,6,4,1.01746105115943
"2882","underlying",18,24,6,4,1.10995751035574
"2883","understand",38,59,21,49,0.779613013226055
"2884","understanding",17,26,9,9,0.801635979701368
"2885","undiluted",4,7,3,1,0.647475214374182
"2886","unevenand",14,17,3,1,1.5724398063373
"2887","unfortunately",28,40,12,16,0.924964591963116
"2888","unhealthy",4,7,3,1,0.647475214374182
"2889","unless",45,60,15,25,1.10995751035574
"2890","unnecessary",9,12,3,1,1.10995751035574
"2891","unpickedpopped",4,7,3,1,0.647475214374182
"2892","unprofessional",4,7,3,1,0.647475214374182
"2893","untill",4,7,3,1,0.647475214374182
"2894","unusual",4,7,3,1,0.647475214374182
"2895","upand",18,24,6,4,1.10995751035574
"2896","update",15,21,6,4,0.971212821561272
"2897","updates",9,12,3,1,1.10995751035574
"2898","upits",11,14,3,1,1.29495042874836
"2899","upon",15,21,6,4,0.971212821561272
"2900","upped",4,7,3,1,0.647475214374182
"2901","upper",4,7,3,1,0.647475214374182
"2902","ups",9,12,3,1,1.10995751035574
"2903","upsetting",4,7,3,1,0.647475214374182
"2904","us",60,84,24,64,0.971212821561272
"2905","usa",4,7,3,1,0.647475214374182
"2907","usebenzol",9,12,3,1,1.10995751035574
"2908","used",263,359,96,1024,1.03769465160862
"2909","user",9,12,3,1,1.10995751035574
"2910","users",11,14,3,1,1.29495042874836
"2911","uses",4,7,3,1,0.647475214374182
"2913","usingbenzoyl",9,12,3,1,1.10995751035574
"2914","usual",8,14,6,4,0.647475214374182
"2915","usually",138,192,54,324,0.986628898093991
"2916","uttered",11,14,3,1,1.29495042874836
"2917","value",4,7,3,1,0.647475214374182
"2918","vanicream",9,12,3,1,1.10995751035574
"2919","vanicreams",11,14,3,1,1.29495042874836
"2920","vanishes",9,12,3,1,1.10995751035574
"2921","vaporub",4,7,3,1,0.647475214374182
"2922","varies",18,24,6,4,1.10995751035574
"2923","various",11,14,3,1,1.29495042874836
"2924","vaseline",15,21,6,4,0.971212821561272
"2925","vegan",77,98,21,49,1.29495042874836
"2926","vegetables",24,30,6,4,1.38744688794467
"2927","vegetarian",4,7,3,1,0.647475214374182
"2928","veggies",33,42,9,9,1.29495042874836
"2929","vera",33,51,18,36,0.786219903168649
"2930","version",8,14,6,4,0.647475214374182
"2931","versus",9,12,3,1,1.10995751035574
"2932","vichy",9,12,3,1,1.10995751035574
"2933","video",36,48,12,16,1.10995751035574
"2934","videos",14,17,3,1,1.5724398063373
"2935","videosome",9,12,3,1,1.10995751035574
"2936","visibly",14,17,3,1,1.5724398063373
"2937","visited",4,7,3,1,0.647475214374182
"2938","visiting",4,7,3,1,0.647475214374182
"2939","vit",37,49,12,16,1.13308162515482
"2940","vitalits",4,7,3,1,0.647475214374182
"2941","vitamin",148,205,57,361,0.997988112381257
"2942","vitamins",68,98,30,100,0.906465300123854
"2943","w",50,62,12,16,1.43369511754283
"2944","wage",4,7,3,1,0.647475214374182
"2945","wait",65,92,27,81,0.945519360673408
"2946","waited",14,17,3,1,1.5724398063373
"2947","waiting",15,21,6,4,0.971212821561272
"2948","waitmins",11,14,3,1,1.29495042874836
"2949","waitminutes",14,17,3,1,1.5724398063373
"2950","wake",20,26,6,4,1.20245396955205
"2951","walked",4,7,3,1,0.647475214374182
"2952","walmart",9,12,3,1,1.10995751035574
"2953","wanna",15,18,3,1,1.66493626553361
"2954","want",224,308,84,784,1.01746105115943
"2955","wanted",8,14,6,4,0.647475214374182
"2956","wants",9,12,3,1,1.10995751035574
"2957","warm",26,38,12,16,0.878716362364961
"2958","warmer",20,26,6,4,1.20245396955205
"2959","warning",14,17,3,1,1.5724398063373
"2960","wary",4,7,3,1,0.647475214374182
"2961","wasand",4,7,3,1,0.647475214374182
"2962","wascleared",14,17,3,1,1.5724398063373
"2963","wash",323,440,117,1521,1.04354979606095
"2964","washad",9,12,3,1,1.10995751035574
"2965","washcloth",9,12,3,1,1.10995751035574
"2966","washed",33,42,9,9,1.29495042874836
"2967","washes",15,21,6,4,0.971212821561272
"2968","washhelp",4,7,3,1,0.647475214374182
"2969","washing",64,94,30,100,0.869466716445329
"2970","wasnow",14,17,3,1,1.5724398063373
"2971","wasnt",33,48,15,25,0.887966008284592
"2972","wastedyears",6,9,3,1,0.832468132766805
"2973","wasthats",4,7,3,1,0.647475214374182
"2974","waswent",9,12,3,1,1.10995751035574
"2975","watch",22,31,9,9,0.955796745028554
"2976","watched",4,7,3,1,0.647475214374182
"2977","water",199,298,99,1089,0.835271055772754
"2978","waterglasses",9,12,3,1,1.10995751035574
"2980","ways",11,17,6,4,0.786219903168649
"2981","wayyyyy",15,21,6,4,0.971212821561272
"2982","wear",139,181,42,196,1.19584707960946
"2983","wearing",93,120,27,81,1.23328612261749
"2984","weather",11,14,3,1,1.29495042874836
"2985","website",9,12,3,1,1.10995751035574
"2986","websites",4,7,3,1,0.647475214374182
"2987","wednesday",8,14,6,4,0.647475214374182
"2988","wednesdaysuper",14,17,3,1,1.5724398063373
"2989","week",169,232,63,441,1.02186564445449
"2990","weekorof",4,7,3,1,0.647475214374182
"2991","weeks",136,190,54,324,0.976351513738845
"2992","weeksmonths",9,12,3,1,1.10995751035574
"2993","weigh",14,17,3,1,1.5724398063373
"2994","weighed",11,14,3,1,1.29495042874836
"2995","weighti",4,7,3,1,0.647475214374182
"2996","weird",19,28,9,9,0.863300285832242
"2997","welcome",13,19,6,4,0.878716362364961
"2998","well",379,520,141,2209,1.02336508046983
"2999","welling",15,18,3,1,1.66493626553361
"3000","went",182,251,69,529,1.00941788079453
"3001","werent",11,14,3,1,1.29495042874836
"3002","wet",26,38,12,16,0.878716362364961
"3003","weyear",4,7,3,1,0.647475214374182
"3004","wfpbdcured",9,12,3,1,1.10995751035574
"3005","whatever",47,59,12,16,1.3643227731456
"3006","whats",102,141,39,169,1.00323082666769
"3007","whatsoever",8,14,6,4,0.647475214374182
"3008","wheat",17,20,3,1,1.84992918392623
"3009","whenever",20,29,9,9,0.894132438897679
"3010","whether",9,12,3,1,1.10995751035574
"3011","whey",26,38,12,16,0.878716362364961
"3012","whiledo",4,7,3,1,0.647475214374182
"3013","whilei",4,7,3,1,0.647475214374182
"3014","whilst",11,14,3,1,1.29495042874836
"3015","white",51,69,18,36,1.06370928075758
"3016","whiteheads",4,7,3,1,0.647475214374182
"3017","whole",47,68,21,49,0.898537032192742
"3018","whoops",3,6,3,1,0.55497875517787
"3019","wider",11,14,3,1,1.29495042874836
"3021","winter",13,19,6,4,0.878716362364961
"3022","winters",4,7,3,1,0.647475214374182
"3023","wiped",4,7,3,1,0.647475214374182
"3024","wipes",4,7,3,1,0.647475214374182
"3025","wisdom",9,12,3,1,1.10995751035574
"3026","wish",53,77,24,64,0.8902784197645
"3027","wishes",9,12,3,1,1.10995751035574
"3028","witch",4,7,3,1,0.647475214374182
"3029","withbenzoly",4,7,3,1,0.647475214374182
"3030","withdrawingnot",9,12,3,1,1.10995751035574
"3031","within",21,33,12,16,0.763095788369571
"3032","withinhrs",3,6,3,1,0.55497875517787
"3033","withinminutes",4,7,3,1,0.647475214374182
"3034","withmonths",11,14,3,1,1.29495042874836
"3035","without",96,129,33,121,1.0847312033022
"3036","woman",6,9,3,1,0.832468132766805
"3037","women",20,35,15,25,0.647475214374182
"3038","wonder",22,31,9,9,0.955796745028554
"3039","wonderful",4,7,3,1,0.647475214374182
"3040","wonders",13,19,6,4,0.878716362364961
"3041","wont",92,122,30,100,1.128456802195
"3042","word",14,17,3,1,1.5724398063373
"3043","words",11,17,6,4,0.786219903168649
"3044","wore",20,26,6,4,1.20245396955205
"3045","work",253,355,102,1156,0.965771853373254
"3046","worked",172,244,72,576,0.940380668495835
"3047","workers",11,14,3,1,1.29495042874836
"3048","working",46,73,27,81,0.750249057925639
"3049","workits",4,7,3,1,0.647475214374182
"3050","workout",37,46,9,9,1.41827904101011
"3051","works",238,322,84,784,1.06370928075758
"3052","world",4,7,3,1,0.647475214374182
"3053","worlds",9,12,3,1,1.10995751035574
"3054","worried",18,30,12,16,0.693723443972337
"3055","worries",4,7,3,1,0.647475214374182
"3056","worry",22,31,9,9,0.955796745028554
"3057","worrying",11,14,3,1,1.29495042874836
"3058","worse",304,409,105,1225,1.08088719460833
"3059","worseif",11,14,3,1,1.29495042874836
"3060","worst",81,117,36,144,0.901840477164038
"3061","worth",252,342,90,900,1.05445963483795
"3062","woukd",4,7,3,1,0.647475214374182
"3063","wouldnt",44,59,15,25,1.09145821851648
"3064","wowbottles",17,20,3,1,1.84992918392623
"3065","woww",11,14,3,1,1.29495042874836
"3066","wrapped",4,7,3,1,0.647475214374182
"3067","wreak",9,12,3,1,1.10995751035574
"3068","wreck",9,12,3,1,1.10995751035574
"3069","wrinkly",8,11,3,1,1.01746105115943
"3070","write",17,20,3,1,1.84992918392623
"3071","wrong",30,39,9,9,1.20245396955205
"3072","wtf",4,7,3,1,0.647475214374182
"3073","x",44,56,12,16,1.29495042874836
"3074","xweek",8,14,6,4,0.647475214374182
"3075","ya",4,7,3,1,0.647475214374182
"3076","yasmin",8,14,6,4,0.647475214374182
"3077","yay",4,7,3,1,0.647475214374182
"3078","yaz",21,27,6,4,1.24870219915021
"3079","yeah",22,31,9,9,0.955796745028554
"3080","year",123,165,42,196,1.09013684052796
"3081","years",163,229,66,484,0.962804052543426
"3082","yellow",27,36,9,9,1.10995751035574
"3083","yep",9,12,3,1,1.10995751035574
"3084","yes",123,165,42,196,1.09013684052796
"3085","yet",28,40,12,16,0.924964591963116
"3086","yo",28,34,6,4,1.5724398063373
"3087","yogurt",30,42,12,16,0.971212821561272
"3088","youchange",14,17,3,1,1.5724398063373
"3091","young",4,7,3,1,0.647475214374182
"3092","younger",11,14,3,1,1.29495042874836
"3095","yourselfbest",15,18,3,1,1.66493626553361
"3096","youtube",28,34,6,4,1.5724398063373
"3097","youtuber",9,12,3,1,1.10995751035574
"3099","yr",4,7,3,1,0.647475214374182
"3100","yuck",4,7,3,1,0.647475214374182
"3101","zap",3,6,3,1,0.55497875517787
"3102","zapzytbenzoyl",9,12,3,1,1.10995751035574
"3103","zinc",109,151,42,196,0.997640381331647
"3104","zincrich",4,7,3,1,0.647475214374182
"3105","zits",17,26,9,9,0.801635979701368
"3106","zombie",11,14,3,1,1.29495042874836
